border_size=1
usage=map

Gg          , Gg          , Gg          , Gg          , Gg          , Gg          , Gg          , Gg          , Gg          , Gg          , Gg          , Gg          , Gg          , Gg          , Gg          , Gg          , Gg          , Gg          , Gg          , Gg          , Gg          , Gg          , Gg          , Gg          , Gg          , Gg          , Gg          , Gg          , Gg          , Gg          , Gg          , Gg          , Gg          , Gg          , Gg          , Gg          , Gg          , Gg          , Gg          , Gg          , Gg          , Gg          , Gg          , Gg          , Ww          , Ww          , Ww          
Gg          , Gg          , Gg          , Gg          , Gg          , Gg          , Gg          , Gg          , Gg          , Gg          , Gg          , Gg          , Gg          , Gg          , Gg          , Gg          , Gg          , Gg          , Gg          , Gg          , Gd^Fmw      , Gs^Fmw      , Gs^Fmw      , Gg          , Gg          , Gg          , Gg          , Gg          , Ce          , Ce          , Ce          , Gg          , Gg          , Gg          , Gg          , Gg          , Gg          , Gg          , Gg          , Gg          , Gg          , Gg          , Gg          , Ww          , Ww          , Ww          , Ww          
Gg          , Gg          , Gg          , Gg          , Gg^Es       , Gg          , Gg          , Gg          , Gg          , Gg          , Gg          , Gg          , Gg          , Gg          , Gg          , Gg          , Gg          , Gg          , Gg          , Gs^Fmw      , Gs^Fmw      , Gs^Fmw      , Gs^Fmw      , Gd^Fmw      , Gs^Fmw      , Gg          , Gs^Fp       , Gg          , Ce          , 2 Ke        , Ce          , Gg          , Gg          , Gg          , Gg          , Gg          , Gg          , Gg          , Gd^Vo       , Gg          , Gg          , Gg          , Ww          , Ww          , Ww          , Ww          , Rp          
Gg          , Gg          , Gg          , Gg          , Gg          , Gg          , Gg          , Gg          , Gg          , Gg          , Gd^Vo       , Gg          , Gg          , Gg          , Gg          , Gg          , Gg          , Gg          , Gg          , Gg          , Gd^Fmw      , Gs^Fmw      , Gs^Fmw      , Gs^Fmw      , Gs^Fmw      , Gs^Fp       , Gs^Fp       , Gs^Fp       , Gg          , Ce          , Gg          , Gg          , Gg          , Gg          , Gg          , Gg          , Gg          , Gg          , Gg          , Gg          , Gg          , Ww          , Ww          , Ww          , Ww          , Ww          , Gg          
Gg          , Gg          , Gg          , Gd^Vo       , Gg          , Gg          , Gg          , Gg          , Gg          , Gg          , Re^Efm      , Re^Efm      , Re^Efm      , Gg          , Re^Efm      , Gg          , Gg          , Gg          , Gs^Fmw      , Gs^Fmw      , Gll^Fmw     , Gs^Fmw      , Gll^Fms     , Gs^Fmw      , Gs^Fp       , Gll^Fp      , Gll^Fp      , Gs^Fp       , Gs^Fp       , Gs^Fmw      , Gs^Fmw      , Gg          , Gg          , Gg          , Gg          , Gg          , Gg          , Gg          , Wwg         , Gg          , Ww          , Ww          , Ww          , Ww          , Gg          , Gg          , Gg          
Gg          , Gg          , Gg          , Gg          , Gg          , Gg          , Gg          , Gg          , Gg          , Re^Efm      , Re^Efm      , Re^Efm      , Re^Efm      , Re^Efm      , Re^Efm      , Re^Efm      , Gg          , Gs^Fms      , Gs^Fms      , Gll^Fms     , Gll^Fms     , Gll^Fms     , Gll^Fmw     , Gll^Fmw     , Gll^Fp      , Gll^Fp      , Gll^Fmw     , Gll^Fmw     , Gs^Fmw      , Gs^Fmw      , Gs^Fmw      , Gd^Vo       , Gg          , Gg          , Gg          , Gg          , Wwf         , Wwf         , Wwf         , Wwg         , Wwg         , Ww          , Gg          , Gg          , Gg          , Gg          , Gg          
Gg          , Gg          , Re^Efm      , Gg          , Gg          , Gg^Es       , Gg          , Gg          , Gg          , Re^Efm      , Re^Efm      , Re^Efm      , Re^Efm      , Re^Efm      , Re^Efm      , Gg          , Gs^Fms      , Gs^Fms      , Gs^Fms      , Gs^Fms      , Gs^Fms      , Gll^Fms     , Gll^Fms     , Gll^Fp      , Gs^Fp       , Gll^Fp      , Gll^Fmw     , Gll^Fms     , Gd^Vo       , Gs^Fmw      , Gs^Fmw      , Gs^Fmw      , Gs^Fmw      , Gg          , Wwf         , Wwf         , Wwf         , Wwf         , Gs          , Wwg         , Gg          , Gg          , Gg          , Gg          , Re^Gvs      , Re^Gvs      , Re^Gvs      
Re^Efm      , Re^Efm      , Re^Efm      , Re^Efm      , Gg          , Gg          , Gg          , Gg          , Gg^Fet      , Re^Efm      , Re^Efm      , Re^Efm      , Re^Efm      , Re^Efm      , Gg          , Gg          , Gg          , Gs^Fms      , Gs^Fms      , Gd^Vo       , Gs^Fms      , Gll^Fms     , Gll^Fp      , Gll^Fp      , Gll^Fp      , Gll^Fp      , Gll^Fp      , Gs^Fmw      , Gs^Fmw      , Gs^Fms      , Gs^Fmw      , Gs^Fmw      , Gs^Fmw      , Gs^Fmw      , Wwg         , Wwf         , Ds          , Gs          , Gg          , Gg          , Gg          , Gg          , Gg          , Re^Gvs      , Re^Gvs      , Re^Gvs      , Re^Gvs      
Re^Efm      , Re^Efm      , Re^Efm      , Re^Efm      , Gg          , Gg          , Gg          , Gg          , Gg          , Gg          , Gg          , Re^Efm      , Gd^Vo       , Gg          , Gg          , Gg          , Gs^Fms      , Gs^Fms      , Gll^Fms     , Gll^Fms     , Gll^Fms     , Gll^Fms     , Gll^Fp      , Gll^Fp      , Gll^Fms     , Gll^Fp      , Gll^Fp      , Gll^Fp      , Gs^Fp       , Gs^Fp       , Gs^Fms      , Gs^Fmw      , Ww          , Ww          , Ww          , Wwg         , Gg          , Gg          , Gg          , Gg          , Gg          , Gg          , Gg          , Re^Gvs      , Re^Gvs      , Re^Gvs      , Re^Gvs      
Gg          , Gg          , Re^Efm      , Re^Efm      , Re^Efm      , Gg          , Gd^Vo       , Gg          , Gg          , Gg          , Gg          , Gg          , Gg          , Gg          , Gg          , Gg          , Gg          , Gs^Fms      , Gs^Fms      , Gll^Fms     , Gll^Fms     , Gll^Fp      , Gll^Fms     , Gll^Fms     , Gd^Vo       , Gs^Fms      , Gll^Fms     , Gs^Fp       , Gs^Fp       , Gs^Fp       , Ww          , Ww          , Ww          , Ww          , Ww          , Ds          , Gg          , Gg          , Gg          , Gg          , Gg          , Gg          , Gg^Vl       , Re^Gvs      , Re^Gvs      , Re^Gvs      , Re^Gvs      
Gg          , Gg          , Re^Efm      , Re^Efm      , Re^Efm      , Gg          , Gg          , Gg          , Gg          , Gg          , Gg          , Gg          , Gg          , Gg          , Gg          , Gg          , Gs^Fms      , Gs^Fms      , Gd^Vo       , Gs^Fms      , Gs^Fms      , Gll^Fms     , Gll^Fms     , Gll^Fms     , Gs^Fms      , Gs^Fms      , Gs^Fms      , Gs^Fp       , Ww          , Ww          , Ww          , Ww          , Ww          , Ww          , Gg          , Gg          , Gg          , Gg          , Gg          , Gg          , Gg          , Gg          , Re^Gvs      , Re^Gvs      , Re^Gvs      , Re^Gvs      , Re^Gvs      
Gg          , Gg          , Re^Efm      , Re^Efm      , Gg          , Gg          , Gg          , Gg          , Gg          , Gg          , Gg          , Gg          , Gg          , Gg^Fet      , Gg          , Gg          , Gg          , Gg          , Gg          , Gs^Fms      , Gll^Fms     , Gll^Fms     , Gll^Fms     , Gll^Fms     , Gll^Fms     , Gs^Fms      , Gs^Fms      , Gs^Fms      , Ww          , Wo          , Ww          , Ww          , Gg          , Gg          , Gg          , Gg          , Gg          , Gs^Fds      , Gg          , Gg          , Gg          , Gg          , Re^Gvs      , Re^Gvs      , Re^Gvs      , Re^Gvs      , Re^Gvs      
Re^Efm      , Re^Efm      , Re^Efm      , Re^Efm      , Gg          , Gg          , Gg          , Gg          , Gg          , Gg          , Gg          , Gg          , Gg          , Gg          , Gg          , Gg^Esd      , Gg          , Gg          , Gs^Fms      , Gs^Fms      , Gs          , Gg          , Gs^Fms      , Gs^Fms      , Gs^Fms      , Gs^Fms      , Ww          , Ww          , Wo          , Wo          , Ww          , Gg^Vh       , Gg          , Gg          , Gg          , Gg          , Gg          , Gg          , Gg          , Gg          , Gg          , Gg          , Re^Gvs      , Re^Gvs      , Ket         , Re^Gvs      , Re^Gvs      
Re^Efm      , Re^Efm      , Re^Efm      , Re^Efm      , Gg          , Gg          , Gg          , Gg          , Gg          , Gg          , Gg          , Gg          , Gg^Es       , Gg          , Gd^Vo       , Gg          , Gg          , Gg          , Gs          , Gs          , Gs          , Gs          , Gs          , Gs          , Wwf         , Ww          , Wo          , Wo          , Ww          , Ww          , Gg          , Gg          , Gg          , Gg          , Gs^Fds      , Gg          , Gg          , Gg          , Gg          , Gg          , Gg          , Gg^Vl       , Gg          , Ket         , 3 Ke        , Ket         , Re^Gvs      
Gg          , Gg          , Ce          , Gd^Vo       , Gg          , Gg          , Gg          , Hh          , Gg          , Gg          , Gg          , Hh          , Gg          , Gg          , Gg          , Gg          , Gg          , Gg          , Gg          , Gs          , Ds          , Ds          , Ww          , Ww          , Ww          , Ww          , Ww          , Ww          , Gg          , Gg          , Gg          , Gg          , Gg          , Gg          , Gg          , Gg          , Gg          , Gg          , Gg          , Gg          , Gg          , Gg          , Re^Gvs      , Ket         , Ket         , Ket         , Gg          
Gg          , Ce          , 1 Ke        , Ce          , Gg          , Gg          , Gg          , Gg          , Gd^Vo       , Gg          , Gg          , Gg          , Gg          , Gg^Es       , Gd^Fetd     , Gg          , Gg          , Gg          , Ds          , Ds          , Ww          , Ww          , Wo          , Wo          , Ww          , Ww          , Gg          , Gg          , Gg          , Gg          , Gg          , Gg          , Gg          , Gg          , Gg          , Gg          , Gg          , Gg          , Gg          , Gg          , Re^Gvs      , Re^Gvs      , Re^Gvs      , Re^Gvs      , Re^Gvs      , Gg          , Gg          
Gg          , Ce          , Ce          , Ce          , Gg          , Gg          , Gg          , Gg          , Gg          , Gg          , Gg          , Gg          , Gg          , Gg^Es       , Gg          , Gg          , Ds          , Ds          , Ww          , Ww          , Wo          , Wo          , Ww          , Ww          , Gg          , Gg          , Gg          , Gg          , Gs^Fds      , Gg          , Gg          , Gg          , Gg          , Gg          , Gg          , Gg          , Re          , Re          , Gg          , Gg          , Re^Gvs      , Re^Gvs      , Re^Gvs      , Re^Gvs      , Re^Gvs      , Gg          , Gg          
Gg          , Gg          , Gg          , Gg          , Gg          , Gg          , Gg          , Gg          , Gg          , Gg          , Gg          , Gg          , Gg          , Gg          , Gg          , Gg          , Ds          , Ww          , Ww          , Wo          , Ww          , Ww          , Ds          , Gg          , Gg          , Gg          , Gg          , Gg          , Gg          , Gg          , Gg          , Gg          , Re          , Gg          , Re          , Re          , Gg          , Gg          , Gg          , Gg^Vh       , Re^Gvs      , Re^Gvs      , Re^Gvs      , Re^Gvs      , Re^Gvs      , Gg          , Gg          
Gg          , Gg          , Gg          , Gg          , Gg          , Gg          , Gg          , Gg          , Gg          , Gg          , Gg          , Gg          , Gg          , Gg          , Ds          , Ds          , Ww          , Ww          , Ww          , Ww          , Ds          , Ds          , Gg          , Gg          , Gg          , Gg          , Gg          , Gg          , Gg          , Gg          , Re          , Re          , Gg          , Re          , Gg          , Gg          , Gg          , Gg          , Gg          , Gg          , Gg          , Re^Gvs      , Re^Gvs      , Re^Gvs      , Gg          , Gg          , Gg          
Gg          , Gg          , Gg          , Gg          , Gg          , Gg          , Hh^Fms      , Gg          , Gg          , Gg          , Gg          , Gg          , Ds          , Ds          , Ww          , Ww          , Wo          , Wo          , Ww          , Wwf         , Gg          , Gg          , Re          , Gg          , Re          , Gg          , Re          , Gg          , Re          , Re          , Re^Gvs      , Re^Gvs      , Re^Gvs      , Gg          , Gg          , Gg          , Gg          , Gg          , Gg          , Gg          , Gg          , Gg          , Gg          , Gg          , Gg          , Gg          , Gg          
Hh          , Hh          , Hh          , Gg          , Gg          , Gg          , Gg          , Gg          , Gd^Vo       , Gg          , Ds          , Ds          , Ww          , Ww          , Ww          , Wo          , Wo          , Ww          , Ww          , Ds          , Gg          , Gg^Vh       , Re          , Re          , Gg          , Re          , Gg          , Re          , Re^Gvs      , Re^Gvs      , Re^Gvs      , Re^Gvs      , Re^Gvs      , Gg          , Gg          , Gg          , Gg          , Gg          , Gg          , Gg          , Gg          , Gg          , Gg          , Gg          , Gg          , Gg          , Gg          
Hh^Fp       , Hh^Fp       , Hh^Fp       , Hhd^Vhhr    , Gg          , Gg          , Gg          , Gg          , Ds          , Ds          , Ww          , Ww          , Ww          , Ww          , Wo          , Wo          , Ww          , Ww          , Gg          , Gg          , Re          , Re          , Re          , Gg          , Re^Gvs      , Re^Gvs      , Re^Gvs      , Gg          , Re^Gvs      , Re^Gvs      , Re^Gvs      , Re^Gvs      , Gg          , Gg          , Gg          , Gg          , Gg          , Gg          , Gg          , Gg          , Gg          , Gg          , Gg          , Gg          , Gg          , Gg          , Gg          
Hh^Fms      , Hh^Fp       , Hh^Fp       , Gg          , Gg          , Gg          , Gg          , Gg          , Ds          , Wwg         , Ww          , Ww          , Wo          , Wo          , Ww          , Ww          , Ds          , Ds          , Gg          , Re          , Re          , Re          , Gg          , Gg          , Re^Gvs      , Re^Gvs      , Re^Gvs      , Gg          , Gg          , Re^Gvs      , Gg^Vl       , Gg          , Re^Gvs      , Re^Gvs      , Re^Gvs      , Gg          , Gg          , Gg          , Gg          , Gg          , Gg          , Gg          , Gg          , Gg          , Gg          , Gg          , Gg          
Hh^Fms      , Hh^Fp       , Hh^Fms      , Hh          , Gg          , Gg          , Gg          , Ds          , Ds          , Wwg         , Ww          , Wo          , Wo          , Ww          , Ds          , Ds          , Gg          , Gg          , Re          , Re          , Gg          , Gg          , Gg          , Gg          , Gg^Vl       , Re^Gvs      , Gg          , Gg          , Gs^Fms      , Gs^Fms      , Gs^Fms      , Gg          , Re^Gvs      , Re^Gvs      , Re^Gvs      , Gg^Wm       , Re^Gvs      , Gg          , Gg          , Gg          , Gg          , Gg          , Gg          , Gg          , Wwg         , Gg          , Gg          
Hh          , Hh^Fms      , Hhd^Vhhr    , Gg          , Gg          , Gg          , Ds          , Ds          , Wwg         , Wwg         , Ww          , Wo          , Ww          , Ww          , Ds          , Gg          , Gg          , Gg          , Re          , Gg          , Gg          , Gg          , Gg          , Gg          , Gg          , Gg          , Gg          , Gs^Fms      , Gs^Fms      , Gs^Fms      , Gs^Fms      , Gs^Fms      , Gg          , Re^Gvs      , Re^Gvs      , Re^Gvs      , Re^Gvs      , Re^Gvs      , Gg          , Gg          , Gg          , Gg          , Ds          , Wwg         , Wwg         , Wwg         , Gg          
Gg          , Hh          , Gg          , Gg          , Ds          , Ds          , Wwg         , Wwg         , Wwg         , Wwg         , Wwg         , Ww          , Ds          , Ds          , Re          , Re          , Re          , Re          , Gg          , Gg          , Gg          , Gg          , Gg          , Gg          , Re^Gvs      , Re^Gvs      , Re^Gvs      , Gg          , Gs^Fms      , Gs^Fms      , Gs^Fms      , Gs^Fms      , Gs^Fp       , Re^Gvs      , Re^Gvs      , Re^Gvs      , Re^Gvs      , Re^Gvs      , Gg          , Gg          , Gg          , Gg          , Gg          , Ds          , Gg          , Gg          , Gg          
Gg          , Gg          , Ds          , Ds          , Ww          , Ww          , Ww          , Wwg         , Wwf         , Wwf         , Wwf         , Ds          , Re          , Re          , Re          , Re          , Gg          , Re          , Re          , Gg          , Gg          , Gg          , Gg          , Gg^Vl       , Re^Gvs      , Re^Gvs      , Re^Gvs      , Re^Gvs      , Gs^Fms      , Gs^Fms      , Gs^Fms      , Gs^Fms      , Gs^Fp       , Gs^Fp       , Gg          , Gg          , Gs^Fp       , Gs^Fp       , Gg          , Gg          , Gg          , Gg          , Gg          , Gg          , Gg          , Gg          , Gg          
Ds          , Ds          , Ww          , Ww          , Ww          , Ww          , Ww          , Wwg         , Ds          , Wwf         , Re          , Re          , Re          , Re          , Gg          , Gg          , Gg          , Gg          , Gg^Vh       , Re          , Re          , Gg          , Gg          , Gg          , Gg          , Re^Gvs      , Gs^Fms      , Gs^Fms      , Gs^Fms      , Gs^Fms      , Gs^Fms      , Gs^Fms      , Gs^Fp       , Gs^Fp       , Gs^Fms      , Gs^Fms      , Gs^Fp       , Gs^Fp       , Gg          , Gg          , Gg          , Gg          , Gg          , Gg          , Gg          , Gg          , Re^Gvs      
Ds          , Ds          , Ww          , Ww          , Wo          , Wo          , Ww          , Wwg         , Ds          , Gg          , Re          , Re          , Re          , Gg          , Gg          , Gg          , Gg          , Gg          , Gg          , Gg          , Gg          , Re          , Re          , Gg          , Gg          , Gs^Fms      , Gs^Fms      , Gg^Vl       , Gs^Fms      , Gs^Fms      , Gll^Fms     , Gs^Fms      , Gs^Fp       , Gs^Fp       , Gs^Fp       , Gs^Fms      , Gs^Fms      , Gs^Fp       , Gs^Fp       , Gg          , Gg          , Gg          , Gg          , Gg          , Re^Gvs      , Re^Gvs      , Re^Gvs      
Ww          , Ww          , Wo          , Wo          , Ww          , Ww          , Ww          , Wwg         , Ds          , Gg          , Re          , Re          , Re          , Gg          , Gg          , Gg          , Gg          , Gg          , Gg          , Gg          , Gg          , Gg          , Re          , Gg          , Re^Gvs      , Gg          , Gs^Fms      , Gs^Fms      , Gs^Fms      , Gs^Fms      , Gll^Fms     , Gs^Fms      , Gs^Fms      , Gs^Fms      , Gg^Vh       , Gs^Fms      , Gs^Fms      , Gs^Fp       , Gs^Fms      , Gs^Fp       , Gs^Fp       , Gg          , Gg          , Gg          , Re^Gvs      , Re^Wm       , Re^Gvs      
Wo          , Wo          , Ww          , Ww          , Ww          , Ww          , Ds          , Ds          , Gg          , Gg          , Re          , Re          , Gg          , Gg          , Gs^Fms      , Gg          , Gg          , Gg          , Gg          , Gs^Fms      , Gs^Fms      , Gg          , Re          , Gg^Vh       , Re^Gvs      , Re^Gvs      , Gs^Fms      , Gs^Fms      , Gll^Fms     , Gll^Fms     , Gs^Fms      , Gll^Fms     , Gs^Fms      , Gs^Fms      , Gs^Fms      , Gs^Fms      , Gs^Fp       , Gs^Fp       , Gs^Fp       , Gs^Fms      , Gs^Fp       , Gg          , Gg          , Gg          , Gg          , Re^Gvs      , Re^Gvs      
Ww          , Wo          , Ww          , Ww          , Ds          , Ds          , Gg          , Gg          , Gg          , Re          , Re          , Re          , Gg          , Gg          , Gs^Fds      , Gs^Fms      , Gs^Fds      , Gs^Fms      , Gs^Fds      , Gs^Fms      , Gg          , Gg          , Gg          , Re          , Gg          , Gs^Fms      , Gs^Fms      , Gs^Fms      , Gs^Fms      , Gll^Fms     , Gll^Fms     , Gll^Fms     , Gll^Fms     , Gs^Fms      , Gll^Fms     , Gs^Fms      , Gs^Fms      , Gs^Fms      , Hh^Fms      , Gs^Fp       , Hh^Fp       , Gs^Fp       , Hh^Fp       , Hh^Fp       , Hh          , Gg          , Gg          
Ww          , Ww          , Ds          , Ds          , Gg          , Gg          , Gg          , Gg          , Re          , Re          , Re          , Gg          , Gs^Fds      , Gs^Fds      , Gs^Fds      , Gs^Fds      , Gs^Fds      , Gs^Fds      , Gs^Fms      , Gs^Fms      , Gs^Fms      , Gs^Fms      , Gg          , Re          , Re          , Gg          , Gs^Fms      , Gs^Fms      , Gs^Fms      , Gs^Fms      , Gs^Fms      , Gs^Fms      , Gs^Fms      , Gll^Fms     , Gs^Fms      , Gll^Fms     , Gs^Fms      , Gs^Fp       , Hh^Fms      , Hh^Fp       , Hh^Fp       , Gs^Fms      , Gg          , Hh          , Gg          , Gg          , Gg          
Ds          , Ds          , Gg          , Gg          , Gg          , Gg          , Gg          , Gg          , Re          , Re          , Gg          , Gg          , Gg          , Gs^Fds      , Gs^Fds      , Gs^Fds      , Gs^Fms      , Gs^Fms      , Gs^Fms      , Gs^Fms      , Gs^Fms      , Gs^Fms      , Gg          , Gg          , Re          , Gg          , Gs^Fds      , Gs^Fms      , Gs^Fds      , Gs^Fms      , Gs^Fms      , Gs^Fms      , Gg^Vh       , Gs^Fms      , Gs^Fms      , Gs^Fms      , Gs^Fms      , Gs^Fms      , Gs^Fms      , Gs^Fms      , Hh^Fms      , Hh^Fp       , Hh          , Hh          , Hh          , Gg          , Gg          
Gg          , Gg          , Re^Gvs      , Gg          , Gg          , Gg          , Gg          , Re          , Re          , Re          , Gg          , Gg          , Gs^Fds      , Gs^Fds      , Gs^Fds      , Gs^Fms      , Gg^Ve       , Gs^Fms      , Gs^Fms      , Gs^Fms      , Gll^Fms     , Gs^Fms      , Gs^Fms      , Gs^Fms      , Gg          , Re          , Re          , Gs^Fds      , Gs^Fds      , Gs^Fds      , Gs^Fds      , Gs^Fds      , Gs^Fds      , Gs^Fms      , Gs^Fms      , Gs^Fms      , Gs^Fms      , Hh^Fp       , Hh^Fp       , Hh          , Hh^Fp       , Hh          , Mm          , Hh          , Hh          , Gg          , Gg          
Re^Gvs      , Re^Gvs      , Re^Wm       , Re^Gvs      , Re^Gvs      , Gg          , Ket         , Re          , Re          , Gg          , Gg          , Gs^Fds      , Gs^Fds      , Gs^Fds      , Gs^Fds      , Gs^Fms      , Gs^Fds      , Gs^Fds      , Gs^Fms      , Gll^Fms     , Gll^Fms     , Gll^Fms     , Gll^Fms     , Gs^Fms      , Gs^Fms      , Gs^Fms      , Gs^Vh       , Re          , Re          , Gs^Fds      , Gs^Fds      , Gs^Fds      , Gs^Fds      , Gs^Fds      , Gs^Fds      , Gg          , Gg          , Gg          , Hh^Fp       , Hh^Fp       , Hh^Fp       , Hh          , Mm          , Hh          , Hh          , Gg          , Gg          
Re^Gvs      , Re^Gvs      , Re^Gvs      , Re^Gvs      , Gg          , Ket         , 4 Ke        , Ket         , Gg^Vh       , Gg          , Gg          , Gg          , Gs^Fds      , Gs^Fds      , Gs^Fds      , Gs^Fds      , Gs^Fds      , Gs^Fms      , Gs^Fms      , Gs^Fms      , Gs^Fms      , Gll^Fms     , Gs^Fms      , Gs^Fms      , Gll^Fms     , Gs^Fms      , Gs^Fms      , Gs^Fms      , Gs^Fms      , Re          , Re          , Re          , Re          , Gs^Fds      , Gg          , Gg          , Gg          , Gg          , Gg          , Hh^Fp       , Hh^Fp       , Hh^Fp       , Mm          , Mm          , Hh          , Gg          , Gg          
Gg          , Re^Gvs      , Re^Gvs      , Gg          , Re          , Ket         , Ket         , Ket         , Gg          , Gg          , Gg          , Gs^Fds      , Gs^Fds      , Gg          , Gs^Fds      , Gs^Fds      , Gs^Fms      , Hh^Fms      , Hh^Fms      , Hh^Fms      , Hh^Fms      , Gll^Fms     , Gs^Fms      , Gll^Fms     , Gll^Fms     , Gs^Fms      , Gs^Fms      , Gs^Fms      , Gs^Fms      , Gs^Fms      , Gg          , Gg          , Gg          , Re          , Re          , Gg          , Gg          , Gg          , Gg          , Hh          , Hh          , Hh^Fp       , Hh^Fp       , Mm          , Mm          , Hh          , Hh          
Re          , Gg          , Re          , Re          , Gg          , Gg          , Gg          , Gg          , Gg          , Gg          , Gg          , Gs^Fds      , Gs^Fds      , Gg          , Gs^Fds      , Gs^Fds      , Gs^Fms      , Hh^Fms      , Hh^Fms      , Hh^Fms      , Hh^Fms      , Hh^Fms      , Gs^Fms      , Gs^Fms      , Gs^Fms      , Gs^Fms      , Gs^Fms      , Gs^Fms      , Gs^Fms      , Gs^Fms      , Gg          , Gg          , Gg          , Gg          , Gg          , Re          , Gg          , Gg          , Gg          , Gg          , Hh          , Hh^Fp       , Hh          , Hh          , Hh          , Hh          , Hh          
