border_size=1
usage=map

Gs^Fp       , Gs^Fp       , Gll^Fp      , Gll^Fp      , Gll^Fp      , Gll^Fp      , Gll^Fp      , Gll^Fp      , Gll^Fp      , Gll^Fp      , Gll^Fp      , Gll^Fp      , Gll^Fp      , Gll^Fp      , Gll^Fp      , Gg          , Gs          , Gs          , Ds          , Ds          , Ds          , Gd          , Gd          , Ds          , Ds          , Ss          , Ss          , Ss          , Ds          , Gd          , Gd          , Ss          , Ss          , Ds          , Ds          , Ds          
Gs^Fp       , Gs^Fp       , Gg^Ve       , Gll^Fp      , Gll^Fp      , Gll^Fp      , Gll^Fp      , Gll^Fp      , Gll^Fp      , Gll^Fp      , Gll^Fp      , Gll^Fp      , Gll^Fp      , Gll^Fp      , Gg          , Gg          , Gs          , Gs          , Ds          , Ds          , Ds          , Gd          , Gd          , Ds          , Ds          , Ss          , Ss          , Ss          , Ds          , Gd          , Gd          , Ss          , Ss          , Ds          , Ds          , Ds          
Gll^Fp      , Gll^Fp      , Gll^Fp      , Gll^Fp      , Gll^Fp      , Gll^Fp      , Gll^Fp      , Gll^Fp      , Gll^Fp      , Gll^Fp      , Gll^Fp      , Gll^Fp      , Gg^Ve       , Gll^Fp      , Gg          , Gs          , Ss          , Ss          , Ds          , Ds          , Gd          , Rr^Vd       , Gd          , Ds          , Ss          , Ss          , Ss          , Ds          , Ds          , Gd          , Re          , Ds          , Ds          , Ss          , Ss          , Ss          
Gll^Fp      , Gll^Fp      , Gll^Fp      , Gll^Fp      , Ce          , Gll^Fp      , Gll^Fp      , Gll^Fp      , Gll^Fp      , Gll^Fp      , Gll^Fp      , Gll^Fp      , Gs          , Gs          , Gs          , Gs          , Ss          , Ds          , Ds          , Ds          , Gd          , Gd          , Gd          , Ss          , Ss          , Ds          , Ds          , Gd          , Ds          , Re          , Ds          , Ds          , Ds          , Ss          , Ss          , Ss          
Gll^Fp      , Gll^Fp      , Gg^Ve       , 3 Ke        , Ce          , Ce          , Gll^Fp      , Gg^Ve       , Gll^Fp      , Gll^Fp      , Gll^Fp      , Gll^Fp      , Gg          , Gs          , Ds          , Gs          , Ds          , Gs          , Gd          , Ss          , Ss          , Gd          , Ds          , Gd          , Ss          , Ss          , Re          , Re          , Re          , Ds          , Ss          , Ss          , Ss          , Ss          , Ss          , Ss          
Gll^Fp      , Gll^Fp      , Ce          , Ce          , Gll^Fp      , Gll^Fp      , Gll^Fp      , Gll^Fp      , Gll^Fp      , Gll^Fp      , Gg          , Gd^Fmw      , Gd^Fmw      , Ds          , Ss          , Gs          , Ss          , Ss          , Ds          , Ds          , Ds          , Ds          , Ss          , Ds          , Ds          , Ww^Bw/      , Gd          , Gd          , Ds          , Ds          , Ds          , Ds          , Ss          , Ds          , Ss          , Ss          
Gll^Fp      , Gll^Fp      , Gll^Fp      , Gll^Fp      , Gll^Fp      , Gll^Fp      , Gll^Fp      , Gs          , Gg          , Gg          , Gs          , Gg^Ve       , Gs          , Gs          , Ds          , Ds          , Ss          , Ds          , Gs          , Gs          , Ss          , Ss          , Ss          , Ss          , Ss          , Ss          , Ds          , Ds          , Gd          , Rr^Vd       , Gd          , Sm          , Gd          , Ss          , Ds          , Ds          
Gll^Fp      , Gll^Fp      , Gll^Fp      , Gg^Ve       , Gll^Fp      , Gll^Fp      , Gs          , Gg          , Gg          , Ss          , Ss          , Gs          , Gs          , Gs          , Gs          , Gs          , Gs          , Ss          , Gs          , Gs          , Gs          , Ds          , Ss          , Ss          , Ss          , Ds          , Ds          , Gd          , Ww          , Gd          , Gd          , Sm          , Gd          , Ss          , Ds          , Ds          
Gll^Fp      , Gll^Fp      , Gll^Fp      , Gll^Fp      , Gg^Ve       , Gd^Fmw      , Gg          , Gs          , Ss          , Ss          , Ww          , Gs          , Gd^Fmw      , Ss          , Ss          , Ss          , Gd          , Gs          , Ds          , Ds          , Ds          , Gd          , Gs          , Ss          , Ss          , Gd          , Gd          , Gd          , Gd          , Gd          , Ds          , Gd          , Ss          , Ss          , Ss          , Ss          
Gg          , Gg          , Gd^Fmw      , Gg          , Gs          , Gs          , Gs          , Gs          , Ww          , Ww          , Gs          , Ss          , Ss          , Ss          , Gs          , Gs          , Gs          , Gs          , Ds          , Ds          , Ds          , Gs          , Gs          , Gd          , Ss          , Ss          , Ss          , Ds          , Gd          , Gd          , Ds          , Ss          , Ss          , Ss          , Sm          , Sm          
Ds          , Gs          , Gs          , Gs          , Ds          , Rd          , Ww^Bw\      , Ww          , Ss          , Ss          , Ss^Vhs      , Ds          , Ss          , Ds          , Gs          , Ds          , Ds          , Ds          , Ds          , Gs          , Gs          , Gs^Fmw      , Gs          , Ds          , Ss          , Ds          , Ds          , Ds          , Rr^Vd       , Ds          , Ds          , Ds          , Ds          , Gd          , Gd          , Sm          
Gs          , Gs          , Gs          , Ds          , Ss^Vhs      , Ww          , Gs          , Rd          , Gs          , Ss          , Ss          , Ss          , Ds          , Ds          , Ds          , Ds          , Ds          , Gs          , Gs          , Gs          , Ss^Vhs      , Gs          , Gs          , Ds          , Ss          , Ds          , Ds          , Ds          , Ds          , Ds          , Ds          , Ds          , Ds          , Gd          , Gd          , Sm          
Gs          , Gs          , Gs          , Ds          , Ww          , Gs          , Gs          , Rd          , Rr^Vd       , Gs          , Ss          , Ds          , Ds          , Ds          , Ss          , Ss          , Ss          , Ss          , Ss          , Ss          , Ds          , Ds          , Gs          , Gs          , Gd          , Ss          , Ss          , Ss          , Gd          , Ss          , Gd          , Gd          , Gd          , Gd          , Gd          , Sm          
Gs          , Gs          , Ss          , Ss          , Ds          , Ds          , Gs          , Rd          , Rd          , Gs          , Ss          , Ss          , Ds          , Ds          , Ds          , Gs          , Ss          , Ss          , Ss          , Ss          , Ds          , Ds          , Ds          , Gs          , Ss          , Ss          , Ss          , Ss          , Ss          , Ss          , Gd          , Gd          , Ss^Vhs      , Gd          , Gd          , Gd          
Ss          , Ss          , Ds          , Ds          , Ds          , Ds          , Ds          , Ds          , Ds          , Ss          , Ss          , Ss          , Ss          , Gs          , Gs          , Gs          , Gs          , Gd          , Gs          , Ss          , Ss          , Ds          , Ds          , Ds          , Ds          , Gs          , Ss          , Ds          , Ds          , Ds          , Ds          , Ds          , Gd          , Gd          , Gd          , Gd          
Gs          , Gs          , Gs          , Ds          , Ds          , Ds          , Ds          , Ds          , Ss          , Ss          , Ss          , Ww^Bw\      , Rd          , Gs          , Gs          , Ss^Vhs      , Gs          , Ds          , Ds          , Ds          , Ds          , Ss          , Ds          , Ds          , Ds          , Gs          , Ds          , Ds          , Ds          , Ds          , Ds          , Ds          , Ds          , Ss          , Sm          , Sm          
Gs          , Gs          , Gs          , Gs          , Ds          , Ds          , Ds          , Ds          , Ss          , Ss          , Ss          , Ss          , Gs          , Rd          , Gs          , Rd          , Gs          , Gs          , Ds          , Ds          , Ds          , Ss          , Ss          , Ss^Vhs      , Ds          , Gs          , Ds          , Ds          , Chs         , Ss          , Ss          , Ss          , Ss          , Ss          , Ss          , Ss          
Gs          , Gs          , Gs          , Gs          , Ss          , Ds          , Ds          , Ds          , Ds          , Ss          , Ds          , Ds          , Ds          , Ds          , Rd          , Rd          , Gs          , Gs          , Gs          , Gs          , Gs          , Gd          , Ss          , Ss          , Ss          , Ds          , Ss          , Chs         , Khs         , Chs         , Ss          , Wwg         , Wwg         , Ss          , Ss          , Ss          
Ss          , Ss          , Ss          , Ss          , Ss          , Ds          , Gs          , Ds          , Gs          , Gs          , Gs          , Ds          , Gd^Fmw      , Ds          , Ds          , Ds          , Ds          , Ds          , Gs          , Gs          , Gs          , Gs          , Gs          , Gs          , Ss          , Ss          , Ss          , Chs         , Chr         , Chr         , Ds          , Ss          , Ss          , Ss          , Ss          , Ss          
Ss          , Ss          , Ss          , Ss          , Ss          , Gs          , Gs          , Gs          , Gs          , Ds          , Ds          , Gs          , Gd          , Ds          , Ds          , Ss          , Ss          , Ss          , Gs          , Gd^Fmw      , Gs          , Ds          , Ds          , Ds          , Ss          , Ss          , Ss          , Ss          , Ds          , Ds          , Ds          , Ds          , Ss          , Gd          , Ss          , Ss          
Gs          , Gs          , Gs          , Ss          , Ss          , Ss          , Gs          , Gs^Fmw      , Gs          , Ss^Vhs      , Gs          , Ds          , Ds          , Ds          , Ds          , Ds          , Ss          , Ss          , Ss          , Ss          , Ds          , Ds          , Ds          , Ds          , Ss          , Ss          , Gd          , Gs          , Ds          , Ds          , Ds          , Ds          , Rr^Vd       , Gs          , Gs          , Gd          
Gs          , Gs          , Gs          , Gs          , Dd          , Dd          , Dd          , Gs          , Gs          , Gs          , Gs          , Ds          , Ds          , Ds          , Ds          , Ss          , Ss          , Ss          , Ss          , Ds          , Ds          , Ds          , Ds          , Ds          , Ss          , Ss          , Ss          , Gs          , Gs          , Gs          , Ds          , Gs          , Gll^Fmf     , Gs          , Gs          , Gs          
Gs          , Gs          , Gs          , Gs          , Dd          , Dd          , Dd          , Gs          , Ss          , Gs          , Ss          , Gs          , Ds          , Ds          , Ds          , Ds          , Gs          , Gs          , Gs          , Ds          , Ds          , Ds          , Ds          , Ds          , Ss          , Ss^Vhs      , Gll^Fmf     , Ss          , Ss          , Gs          , Gs          , Gs          , Gs          , Gs          , Gs          , Gs          
Gs          , Gs          , Gs          , Dd          , Dd          , Dd          , Ss          , Ss          , Ss          , Ss          , Gs          , Gs          , Gs          , Gs          , Gs          , Ss^Vhs      , Gs          , Gs          , Ds          , Ds          , Ds          , Ds          , Gs          , Gs          , Gs          , Ss          , Ss          , Ss          , Gd          , Ss          , Gs          , Ds          , Ds          , Ds          , Gs          , Gs          
Ss          , Ss          , Ss          , Gd          , Gd          , Gs          , Ss          , Dd          , Dd          , Gd          , Gd          , Gll^Fmf     , Gs          , Dd          , Dd          , Ds          , Ss          , Ss          , Ss          , Ds          , Ds          , Ds          , Ds          , Ds          , Ds          , Ss          , Ss          , Ss          , Gg          , Gg          , Gd^Fdf      , Ds          , Ds          , Ds          , Ds          , Ds          
Ss          , Wwg         , Ss          , Ss          , Ss          , Ss          , Ss          , Gd          , Gs          , Sm          , Gd          , Gd          , Gs          , Dd          , Dd          , Ds          , Ds          , Gs          , Gs          , Ds          , Ds          , Ds          , Ds          , Ds          , Ds          , Ds          , Rd          , Rd          , Gs          , Gg^Ve       , Gd^Fdf      , Gs          , Ds          , Gs          , Gs          , Gs          
Gd          , Gd          , Gd          , Gd          , Ss          , Ss          , Ss          , Ss          , Gs          , Sm          , Gd          , Gs          , Dd          , Dd          , Dd          , Dd          , Ds          , Ds          , Gs          , Gs          , Rr^Vd       , Gs          , Gs          , Ds          , Ds          , Ds          , Gs          , Gll^Fmf     , Gg          , Gd^Fdf      , Gd^Fdf      , Gs          , Ss          , Ss          , Ss          , Ss          
Gs          , Gs          , Dd          , Dd          , Dd          , Dd          , Dd          , Dd          , Ds          , Gd          , Gs          , Gs          , Ss          , Gd          , Gd          , Gd          , Dd          , Ds          , Ds          , Ds          , Ds          , Gll^Fmf     , Gs          , Rd          , Rd          , Rd          , Gs          , Gs          , Gll^Fmf     , Gd^Fdf      , Gd^Fdf      , Gd^Fdf      , Gd^Fdf      , Gd^Fdf      , Gll^Fmf     , Gll^Fmf     
Gs          , Gs          , Gs          , Dd          , Dd          , Dd          , Dd          , Chr         , Dd          , Dd          , Dd          , Dd          , Gd          , Ss          , Ss          , Ss          , Dd          , Dd          , Ds          , Ds          , Ds          , Gs          , Ss          , Ss          , Sm          , Ss          , Gs          , Gll^Fmf     , Gll^Fmf     , Gll^Fmf     , Gll^Fmf     , Gd^Fdf      , Gll^Fmf     , Gll^Fmf     , Gll^Fmf     , Gll^Fmf     
Gs          , Gs          , Gs          , Gs          , Dd          , Dd          , Chr         , 2 Khr       , Chr         , Dd          , Dd          , Ss          , Ss          , Ss          , Ss          , Ss          , Dd          , Dd          , Ds          , Ds          , Ds          , Ds          , Ds          , Ss          , Ss          , Ss          , Gll^Fmf     , Gs^Fms      , Gs^Fms      , Gll^Fp      , Gs^Fms      , Gs^Fds      , Gs^Fds      , Gll^Fmf     , Gs^Fds      , Gll^Fmf     
Gs          , Gd          , Gs          , Gd          , Ss          , Ss          , Ss          , Ds          , Dd          , Dd          , Dd          , Dd          , Gs          , Gd          , Ss          , Ss          , Ss          , Ds          , Ds          , Ds          , Ds          , Ds          , Ds          , Ds          , Ss          , Gll^Fmf     , Gs^Fms      , Gs^Fms      , Gs^Fms      , Gs^Fms      , Gs^Fds      , Gs^Fds      , Gs^Fds      , Gs^Fds      , Gs^Fds      , Gs^Fds      
Ss          , Ss          , Ss          , Ss          , Ss          , Gd          , Ds          , Ds          , Gs          , Rr^Vd       , Gs          , Dd          , Gs          , Gd          , Gs          , Gd          , Ss          , Ds          , Ss          , Ss^Vhs      , Ds          , Ds          , Gs          , Gs          , Gll^Fmf     , Gs^Fms      , Gs^Fms      , Gs^Fms      , Gs^Fds      , Gg^Ve       , Gs^Fds      , Gs^Fds      , Gs^Fds      , Gs^Fds      , Cv          , Gs^Fds      
Ss          , Ss          , Ss          , Ss          , Ss          , Ss          , Gd          , Gs          , Re          , Gs          , Dd          , Dd          , Dd          , Dd          , Gs          , Gs          , Gs          , Ss          , Ss          , Ss          , Ss          , Gs          , Ss          , Gs          , Gll^Fmf     , Gs^Fms      , Gll^Fmf     , Gs^Fms      , Gs^Fds      , Gs^Fds      , Gs^Fds      , Gs^Fds      , Cv          , Cv          , Gs^Fds      , Cv          
Gs          , Gd          , Gs          , Gd          , Gs          , Gs          , Dd          , Dd          , Dd          , Re          , Ds          , Dd          , Dd          , Dd          , Dd          , Gs          , Ss          , Ss          , Ss          , Wwg         , Ss          , Ss          , Ss          , Gll^Fmf     , Gll^Fmf     , Gs^Fms      , Gs^Fms      , Gs^Fms      , Gs^Fds      , Gll^Fmf     , Gs^Fds      , Gs^Fds      , Cv          , Gs^Fds      , Gg^Fet      , Gs^Fds      
Gs          , Gs          , Gs          , Gs          , Gs          , Gs          , Dd          , Dd          , Dd          , Ds          , Dd^Dc       , Dd          , Dd          , Dd          , Dd          , Gs          , Ss          , Ss          , Ss          , Ss          , Ss          , Ss          , Ss          , Gs          , Gll^Fmf     , Gs^Fms      , Gs^Fms      , Gs^Fms      , Gs^Fds      , Gs^Fds      , Gs^Fds      , Gs^Fds      , Cv          , Gs^Fds      , Gs^Fds      , Gs^Fds      
