border_size=1
usage=map

Gs          , Gs          , Gs          , Gs          , Gs          , Gs          , Gs          , Gs          , Hh          , Mm          , Xu          , Xu          , Xu          , Xu          , Xu          , Xu          , Xu          , Xu          , Xu          , Xu          , Xu          , Xu          , Xu          , Xu          , Xu          , Xu          , Xu          , Xu          , Xu          , Xu          , Xu          , Xu          , Xu          , Xu          
Gs          , Gs^Fp       , Gs^Fp       , Gs          , Gs          , Gs          , Hh          , Hh          , Mm          , Mm          , Xu          , Xu          , Xu          , Xu          , Rd          , Rd          , Rd          , Rd          , Rd          , Rd          , Xu          , Xu          , Rd          , Rd          , Rd          , Xu          , Xu          , Xu          , Xu          , Xu          , Rd          , Rd          , Uu^Vu       , Xu          
Gs          , Gs          , Gs^Fp       , Gs          , Hh          , Hh          , Hh          , Mm          , Mm          , Xu          , Xu          , Xu          , Rd          , Rd          , Xu          , Xu          , Xu          , Xu          , Xu          , Xu          , Rd          , Rd          , Xu          , Xu          , Xu          , Rd          , Rd          , Xu          , Rd          , Rd          , Xu          , Xu          , Xu          , Xu          
Gs          , Gs^Fp       , Gs^Fp       , Gs          , Hh          , Hh          , Mm          , Mm          , Xu          , Xu          , Xu          , Xu          , Rd          , Xu          , Xu          , Xu          , Xu          , Xu          , Rd          , Rd          , Xu          , Xu          , Uu          , Uu          , Uu          , Xu          , Xu          , Rd          , Rd          , Xu          , Xu          , Xu          , Xu          , Xu          
Gs^Fp       , Gs          , Gs          , Gs          , Hh          , Xu          , Xu          , Xu          , Xu          , Xu          , Xu          , Uh          , Uh          , Rd          , Uu^Uf       , Xu          , Rd          , Rd          , Xu          , Uh          , Uu          , Xu          , Xu          , Xu          , Ql          , Uu          , Xu          , Xu          , Uu          , Xu          , Cud         , 3 Kud       , Xu          , Xu          
Gs^Fp       , Gs^Fp       , Gs          , Gs          , Gs          , Xu          , Xu          , Xu          , Xu          , Xu          , Uu          , Uh          , Rd          , Uu^Uf       , Uu          , Uu^Em       , Rd          , Uu          , Rd          , Ql          , Rd          , Uu          , Ql          , Xu          , Xu          , Uu          , Uu^Uf       , Xu          , Xu          , Cud         , Xu          , Xu          , Xu          , Xu          
Hh          , Gs^Fp       , Gs          , Gs          , Xu          , Xu          , Xu          , Xu          , Uu          , Uu          , Rd          , Rd          , Cud         , Rd          , Rd          , Rd          , Uu          , Rd          , Xu          , Rd          , Uu^Uf       , Rd          , Uu^Uf       , Xu          , Xu          , Rd          , Rd          , Uu^Uf       , Rd          , Xu          , Ql          , Xu          , Xu          , Xu          
Hh          , Gg^Ve       , Hh          , Gs          , Xu          , Xu          , Uh          , Uh          , Rd          , Rd          , Uu          , Cud         , 2 Kud       , Cud         , Uu          , Uu          , Uu          , Ql          , Xu          , Xu          , Uu^Uf       , Rd          , Rd          , Uh          , Uh          , Xu          , Xu          , Rd          , Uu          , Cud         , Rd          , Ql          , Ql          , Xu          
Hh          , Hh          , Hh          , Mm          , Xu          , Xu          , Uh          , Uu          , Rd          , Uu          , Ql          , Cud         , Cud         , Cud         , Uu          , Uu          , Xu          , Xu          , Xu          , Xu          , Uu^Uf       , Uu          , Rd          , Uu^Uf       , Uh          , Xu          , Xu          , Rd          , Rd          , Xu          , Xu          , Rd          , Rd          , Xu          
Gs          , Gs          , Hh          , Mm          , Xu          , Xu          , Ql          , Uu          , Rd          , Uu          , Uu          , Uu          , Uh          , Uh          , Uh          , Uh          , Xu          , Xu          , Uh          , Uu          , Uu          , Ql          , Rd          , Uu^Uf       , Uu^Uf       , Uu^Uf       , Xu          , Uu          , Rd          , Ql          , Xu          , Uu^Uf       , Rd          , Xu          
Gs          , Hh          , Hh          , Mm          , Xu          , Xu          , Ql          , Rd          , Uh          , Xu          , Xu          , Uh          , Xu          , Uh          , Xu          , Xu          , Xu          , Cud         , Xu          , Uh          , Uu          , Rd          , Uu          , Uu^Uf       , Xu          , Uu          , Xu          , Xu          , Rd          , Ql          , Xu          , Uu^Uf       , Rd          , Xu          
Gs          , Hh          , Ce          , Xu          , Uu^Vud      , Uu          , Rd          , Cud         , Uh          , Xu          , Xu          , Xu          , Uh          , Uh          , Xu          , Xu          , Xu          , Xu          , Xu          , Uu^Em       , Rd          , Rd          , Uu^Uf       , Uu          , Ql          , Ql          , Xu          , Xu          , Cud         , Uu          , Xu          , Rd          , Ql          , Xu          
Gs          , 1 Ke        , Ce          , Xu          , Uu          , Uu          , Rd          , Uu          , Xu          , Xu          , Uh          , Uh          , Xu          , Xu          , Xu          , Xu          , Uh          , Xu          , Rd          , Rd          , Uh          , Uh          , Xu          , Xu          , Xu          , Xu          , Xu          , Ql          , Rd          , Xu          , Xu          , Rd          , Uu          , Xu          
Gs          , Ce          , Ce          , Uu          , Rd          , Rd          , Uh          , Xu          , Xu          , Uu^Vu       , Xu          , Xu          , Xu          , Xu          , Uh          , Uh          , Rd          , Uu          , Rd          , Uu^Uf       , Uu^Uf       , Uh          , Xu          , Xu          , Ql          , Xu          , Uh          , Uu^Uf       , Rd          , Uu^Uf       , Xu          , Rd          , Rd          , Xu          
Gs          , Ce          , Ce          , Rd          , Uu          , Uu          , Xu          , Xu          , Xu          , Xu          , Ql          , Ql          , Ql          , Ql          , Uu          , Rd          , Uu          , Rd          , Uu          , Uu^Uf       , Xu          , Xu          , Xu          , Xu          , Uu          , Ql          , Rd          , Rd          , Rd          , Xu          , Rd          , Cud         , Xu          , Xu          
Gs          , Gs          , Hh          , Hh          , Mm          , Xu          , Xu          , Xu          , Uu          , Xu          , Ql          , Xu          , Ql          , Ql          , Rd          , Rd          , Uh          , Uh          , Ql          , Ql          , Xu          , Xu          , Ql          , Uh          , Rd          , Rd          , Rd          , Rd          , Xu          , Xu          , Rd          , Uu^Em       , Xu          , Xu          
Gs          , Gs          , Hh          , Mm          , Xu          , Xu          , Uu          , Uh          , Ql          , Ql          , Rd          , Rd          , Rd          , Rd          , Uu          , Uu          , Xu          , Xu          , Xu          , Xu          , Xu          , Xu          , Uh          , Uh          , Rd          , Uh          , Xu          , Xu          , Ql          , Xu          , Rd          , Uh          , Xu          , Xu          
Hh          , Hh          , Mm          , Xu          , Xu          , Xu          , Cud         , Ql          , Rd          , Rd          , Xu          , Xu          , Xu          , Xu          , Cud         , Uu          , Xu          , Xu          , Xu          , Xu          , Xu          , Uu^Uf       , Uu^Uf       , Rd          , Ql          , Xu          , Xu          , Ql          , Rd          , Rd          , Uh          , Uh          , Xu          , Xu          
Hh          , Hh          , Mm          , Xu          , Cud         , Cud         , Ql          , Qxu^Bs\     , Rd          , Xu          , Xu          , Xu          , Xu          , Xu          , Xu          , Xu          , Rd          , Rd          , Rd          , Rd          , Cud         , Uu^Uf       , Rd          , Rd          , Xu          , Xu          , Ql          , Ql          , Rd          , Uu          , Uh          , Xu          , Xu          , Xu          
Hh          , Hh          , Mm          , Xu          , 4 Kud       , Ql          , Ql          , Rd          , Uu          , Ql          , Xu          , Xu          , Rd          , Rd          , Rd          , Rd          , Uu          , Uu          , Uh          , Uu          , Uu^Uf       , Rd          , Ql          , Ql          , Xu          , Xu          , Uh          , Uh          , Rd          , Rd          , Rd          , Ql          , Xu          , Xu          
Hh          , Hh          , Mm          , Xu          , Uu          , Ql          , Ql          , Rd          , Rd          , Ql          , Rd          , Rd          , Uu          , Ql          , Ql          , Ql          , Ql          , Uu          , Uh          , Uu^Uf       , Uh          , Uu^Uf       , Xu          , Xu          , Ql          , Ql          , Rd          , Cud         , Uh          , Xu          , Xu          , Rd          , Xu          , Xu          
Hh          , Hh          , Mm          , Xu          , Xu          , Uu          , Ql          , Ql          , Ql          , Rd          , Ql          , Uu          , Xu          , Xu          , Xu          , Xu          , Xu          , Xu          , Xu          , Xu          , Xu          , Xu          , Xu          , Xu          , Ql          , Xu          , Rd          , Uh          , Ql          , Xu          , Xu          , Rd          , Xu          , Xu          
Hh          , Hh          , Mm          , Xu          , Xu          , Uu^Vu       , Xu          , Xu          , Xu          , Ql          , Xu          , Xu          , Xu          , Xu          , Ql          , Xu          , Xu          , Xu          , Xu          , Xu          , Xu          , Xu          , Xu          , Xu          , Rd          , Rd          , Uh          , Uh          , Xu          , Xu          , Xu          , Rd          , Xu          , Xu          
Hh          , Hh          , Xu          , Xu          , Xu          , Xu          , Xu          , Xu          , Xu          , Xu          , Xu          , Xu          , Uu^Uf       , Uu^Uf       , Uu          , Uu          , Uu          , Uh          , Uh          , Xu          , Uu^Uf       , Uu^Uf       , Rd          , Rd          , Uu^Uf       , Uu          , Uu^Uf       , Xu          , Xu          , Xu          , Xu          , Rd          , Xu          , Xu          
Gg          , Gg          , Xu          , Xu          , Xu          , Xu          , Ql          , Uu^Emf      , Rd^Emf      , Xu          , Xu          , Ql          , Ql          , Uu^Vu       , Uu          , Uu          , Cud         , Uh          , Uu          , Xu          , Cud         , Uu          , Rd          , Uh          , Uh          , Uu^Uf       , Xu          , Xu          , Xu          , Xu          , Rd          , Rd          , Xu          , Xu          
Xu          , Xu          , Xu          , Xu          , Cud         , Rd          , Ql          , Rd          , Rd^Emf      , Rd^Emf      , Xu          , Xu          , Ql          , Uu          , Uu          , Ql          , 5 Kud       , Ql          , Rd          , Rd          , Cud         , Rd          , Uh          , Uh          , Ql          , Ql          , Xu          , Xu          , Rd          , Rd          , Xu          , Xu          , Xu          , Xu          
Xu          , Xu          , Xu          , Kud         , Cud         , Cud         , Ql          , Rd          , Rd^Emf      , Rd^Emf      , Uh          , Xu          , Xu          , Ql          , Uu          , Cud         , Ql          , Cud         , Uu^Uf       , Uu^Uf       , Xu          , Uu          , Xu          , Xu          , Xu          , Xu          , Rd          , Rd          , Xu          , Xu          , Uu          , Uu          , Uu          , Xu          
Xu          , Xu          , Xu          , Cud         , Cud         , Cud         , Qxu^Bs\     , Rd          , Rd^Emf      , Rd^Emf      , Uh          , Xu          , Xu          , Ql          , Uh          , Uu          , Rd          , Rd          , Uh          , Ql          , Xu          , Xu          , Xu          , Xu          , Rd          , Rd          , Xu          , Xu          , Uu          , Uu          , Xue         , Xu          , Uu          , Xu          
Xu          , Xu          , Xu          , Rd          , Rd          , Ql          , Uu          , Rd          , Rd          , Rd^Emf      , Rd          , Ql          , Ql          , Uh          , Rd          , Rd          , Ql          , Ql          , Ql          , Ql          , Xu          , Xu          , Xu          , Rd          , Rd          , Xu          , Xu          , Xu          , Uu          , Xu          , Xu          , Xue         , Uu          , Xu          
Xu          , Xu          , Xu          , Rd          , Uu^Vu       , Ql          , Ql          , Uu          , Ql          , Rd          , Rd          , Rd          , Cud         , Uh          , Rd          , Ql          , Xu          , Xu          , Xu          , Xu          , Xu          , Xu          , Xu          , Rd          , Rd          , Xu          , Rd          , Rd          , Xue         , Xu          , Xu          , Xu          , Uu          , Xu          
Xu          , Xu          , Xu          , Xu          , Xu          , Xu          , Xu          , Ql          , Xu          , Xu          , Xu          , Xu          , Xu          , Rd          , Xu          , Xu          , Xu          , Xu          , Xu          , Xu          , Xu          , Xu          , Xu          , Xu          , Xu          , Rd          , Xu          , Uu^Vu       , Xu          , Xu          , Xu          , Xu          , Uu          , Xu          
Xu          , Xu          , Xu          , Xu          , Xu          , Xu          , Xu          , Xu          , Xu          , Xu          , Xu          , Xu          , Xu          , Xu          , Xu          , Xu          , Xu          , Xu          , Xu          , Xu          , Xu          , Xu          , Xu          , Xu          , Xu          , Xu          , Xu          , Xu          , Xu          , Xu          , Xu          , Xu          , Xu          , Xu          
