border_size=1
usage=map

Mm          , Mm          , Mm          , Mm          , Mm          , Mm          , Mm          , Mm          , Mm          , Mm          , Mm          , Mm          , Mm          , Mm          , Mm          , Mm          , Mm          , Mm          , Mm          , Mm          , Mm          , Mm          , Mm          , Mm          , Mm          , Mm          , Mm          , Mm          , Mm          , Mm          , Hh          , Hh          , Hh^Fp       , Gs^Fp       , Gg          , Gs^Fp       , Gg          , Gs^Fp       , Gg          , Gg          , Ww          , Ww          , Ww          , Ww          , Gg          
Mm          , Mm          , Mm          , Mm          , Mm          , Mm          , Mm          , Mm          , Mm          , Mm          , Hh          , Hh          , Mm          , Mm          , Mm          , Mm          , Mm          , Mm          , Mm          , Mm          , Mm          , Mm          , Mm          , Mm          , Mm          , Mm          , Gg^Ve       , Mm          , Hh          , Mm          , Hh          , Hh^Fp       , Gg          , Gs^Fp       , Gg          , Gg          , Gg          , Gg          , Gg          , Gg          , Ww          , Ww          , Ds          , Gg          , Gg          
Mm          , Mm          , Mm          , Hh^Vhh      , Hh          , Mm          , Hh          , Hh          , Hh          , Mm          , Hh          , Hh          , Mm          , Mm          , Mm          , Mm          , Hh^Vhh      , Mm          , Mm          , Mm          , Mm          , Mm          , Mm          , Gs^Fp       , Gs^Fp       , Gs^Fp       , Gs^Fp       , Hh          , Hh          , Hh          , Gg          , Gg          , Gg          , Gg          , Gg          , Gg          , Gg          , Gg          , Ww          , Ww          , Ww          , Ww          , Gg          , Gg          , Re          
Mm          , Mm          , Mm          , Hh          , Hh          , Hh          , Hh          , Hh          , Hh^Fp       , Hh^Fp       , Hh^Fp       , Hh^Fp       , Hh^Fp       , Gs^Fp       , Gs^Fp       , Hh          , Hh          , Mm          , Mm          , Mm          , Mm          , Mm          , Gs^Fp       , Gs^Fp       , Gg^Ve       , Gs^Fp       , Gs^Fp       , Gs^Fp       , Gg          , Gg          , Gg          , Gg          , Gg          , Gg          , Re          , Re          , Re          , Ww          , Ww          , Ww          , Gg          , Gg          , Re          , Re          , Gg          
Mm          , Mm          , Hh^Fp       , Hh^Fp       , Hh^Fp       , Hh          , Hh^Fp       , Hh^Fp       , Hh^Fp       , Hh^Fp       , Hh^Fp       , Hh^Fp       , Hh^Fp       , Hh^Fp       , Gs^Fp       , Gs^Fp       , Gs^Fp       , Mm          , Mm          , Mm          , Mm          , Hh          , Gs^Fp       , Gs^Fp       , Gs^Fp       , Gs^Fp       , Gg          , Gs^Fp       , Gg          , Gg          , Gg          , Gg          , Re          , Re          , Gg          , Gg          , Gs^Fp       , Ww^Bw\      , Ds^Bw\      , Gg          , Re          , Re          , Ce          , Gg          , Gg          
Mm          , Mm          , Hh^Fp       , Hh^Fp       , Hh^Fp       , Hh^Fp       , Hh^Fp       , Hh^Fp       , Gg^Ve       , Hh^Fp       , Hh          , Hh          , Hh          , Hh^Fp       , Gs^Fp       , Gs^Fp       , Gs^Fp       , Mm          , Mm          , Mm          , Hh          , Hh          , Gg          , Gg          , Gg          , Gg          , Gg          , Gg          , Gg          , Gg          , Re          , Re          , Gg          , Gg          , Gll^Fp      , Gll^Fp      , Ww          , Ww          , Ww          , Re          , Ce          , 1 Ke        , Ce          , Gg          , Gg          
Re          , Mm          , Mm          , Hh^Fp       , Hh^Fp       , Hh^Fp       , Hh^Fp       , Hh^Fp       , Hh          , Hh          , Hh          , Hh          , Gg          , Hh          , Gg          , Gs^Fp       , Gs^Fp       , Hh          , Hh          , Hh          , Hh          , Gg          , Gg          , Gg          , Gg          , Gg          , Re          , Ww          , Re          , Re          , Gg          , Gg          , Gs^Fp       , Gs^Fp       , Ww          , Ww          , Ww          , Ww          , Re          , Re          , Gg          , Ce          , Gll^Fp      , Gg          , Gll^Fp      
Mm          , Re          , Mm          , Mm          , Mm          , Hh^Fp       , Hh^Fp       , Hh          , Hh          , Hh          , Gg          , Gg          , Gg          , Gg          , Gg          , Gg          , Re          , Re          , Re          , Gg          , Re          , Gg          , Re          , Re          , Re          , Re          , Gg          , Re          , Gg          , Gg          , Gg          , Gg          , Ds          , Ds          , Ww          , Ww          , Gs^Fp       , Gg^Ve       , Re          , Gs^Fp       , Gs^Fp       , Gs^Fp       , Gll^Fp      , Gll^Fp      , Gll^Fp      
Mm          , Re          , Mm          , Mm          , Mm          , Mm          , Hh^Fp       , Hh^Fp       , Gg          , Gg          , Gg          , Gg          , Gg          , Gg          , Re          , Re          , Ww          , Ww          , Ww          , Re          , Ww          , Re          , Ds          , Gg          , Gg          , Ds          , Ww          , Gg          , Ww          , Ds          , Ww          , Ww          , Ww          , Ww          , Ds          , Gg^Ve       , Gs^Fp       , Gs^Fp       , Re          , Gg^Ve       , Gll^Fp      , Gll^Fp      , Gll^Fp      , Gll^Fp      , Gll^Fp      
Mm          , Re          , Mm          , Mm          , Hh^Vhh      , Mm          , Hh          , Hh^Fp       , Gg          , Gg          , Gg          , Gg          , Re          , Re          , Ww          , Ww          , Ww          , Ww          , Ww          , Ww          , Gs^Fp       , Ww          , Ww          , Ds          , Ww          , Ww          , Ww          , Ww          , Ww          , Ww          , Ww          , Ww          , Ww          , Ds          , Gll^Fp      , Gs^Fp       , Gll^Fp      , Gg^Ve       , Re          , Gll^Fp      , Gll^Fp      , Gll^Fp      , Gll^Fp      , Gll^Fp      , Hh          
Mm          , Re          , Mm          , Mm          , Mm          , Mm          , Hh          , Hh          , Gg          , Gg          , Re          , Re          , Gg          , Gg          , Ww          , Ww          , Ds          , Ds          , Gs^Fp       , Gs^Fp       , Gs^Fp       , Gs^Fp       , Ww          , Ww          , Ds          , Ww          , Ds          , Ww          , Gs^Fp       , Ww          , Gs^Fp       , Ww          , Gg^Ve       , Ds          , Ds          , Gll^Fp      , Gll^Fp      , Gll^Fp      , Re          , Gs^Fp       , Gs^Fp       , Hh^Fp       , Hh          , Hh          , Hh          
Mm          , Re          , Mm          , Mm          , Re          , Mm          , Cud         , Cud         , Cud         , Re          , Gg          , Gg          , Ww          , Ww          , Ww          , Ds          , Gg          , Gg          , Gs^Fp       , Gs^Fp       , Gg^Ve       , Ww          , Ds          , Ds          , Gll^Fp      , Ww          , Gg^Ve       , Gs^Fp       , Gs^Fp       , Gs^Fp       , Hh^Fp       , Gs^Fp       , Gs^Fp       , Gs^Fp       , Gs^Fp       , Gs^Fp       , Gs^Fp       , Gs^Fp       , Re          , Gs^Fp       , Hh          , Hh          , Hh          , Hh          , Hh          
Mm          , Re          , Re          , Re          , Mm          , Re          , Cud         , 2 Kud       , Cud         , Re          , Gg          , Gg          , Ww          , Ww          , Ww          , Gg^Ve       , Gs^Fp       , Gs^Fp       , Gs^Fp       , Gs^Fp       , Ww          , Ww          , Ww          , Gll^Fp      , Gll^Fp      , Gs^Fp       , Gll^Fp      , Gs^Fp       , Hh^Fp       , Hh^Fp       , Mm          , Hh^Fp       , Hh          , Hh          , Mm          , Mm          , Mm          , Hh          , Re          , Hh          , Mm          , Mm          , Mm          , Hh          , Mm          
Mm          , Mm          , Mm          , Mm          , Mm          , Mm          , Hh          , Cud         , Gg          , Gg          , Gg          , Gg          , Ww          , Ww          , Ds          , Gs^Fp       , Gs^Fp       , Gs^Fp       , Gs^Fp       , Gs^Fp       , Ww          , Ww          , Ds          , Gs^Fp       , Gll^Fp      , Gll^Fp      , Hh^Fp       , Gll^Fp      , Gs^Fp       , Mm          , Mm          , Mm          , Mm          , Mm          , Mm          , Mm          , Mm          , Hh          , Re          , Hh          , Mm          , Mm          , Mm          , Mm          , Mm          
Mm          , Mm          , Mm          , Mm          , Mm          , Mm          , Mm          , Hh^Fp       , Gg          , Gg          , Gg          , Gg          , Ww          , Ww          , Ds          , Gs^Fp       , Gs^Fp       , Gg^Ve       , Ds          , Ww          , Ww          , Ds          , Gg^Ve       , Gs^Fp       , Gll^Fp      , Hh^Fp       , Mm          , Hh^Fp       , Hh          , Hh          , Hh          , Mm          , Mm          , Mm^Vhh      , Mm          , Mm          , Mm          , Mm          , Re          , Mm          , Mm          , Mm          , Mm          , Mm          , Mm          
Mm          , Mm          , Mm          , Mm          , Mm          , Mm          , Mm          , Hh^Fp       , Gg          , Gg          , Gg          , Gg          , Gg          , Ww          , Ww          , Gs^Fp       , Ds          , Ds          , Ww          , Ww          , Ww          , Ds          , Gs^Fp       , Gs^Fp       , Hh^Fp       , Hh          , Mm          , Hh          , Hh          , Hh          , Hh          , Mm          , Mm          , Mm          , Mm          , Mm          , Mm          , Mm          , Re          , Mm          , Mm          , Mm          , Mm          , Mm          , Mm          
Mm          , Mm          , Mm          , Mm          , Hh          , Mm          , Hh^Fp       , Hh^Fp       , Gg          , Gg          , Gg          , Gg          , Gg          , Gg          , Gs^Fp       , Ww          , Ww          , Ds          , Ww          , Ww          , Ww          , Gs^Fp       , Gs^Fp       , Gs^Fp       , Hh          , Mm          , Mm          , Mm^Vhh      , Mm          , Mm          , Mm          , Mm          , Mm          , Mm          , Mm          , Mm          , Mm          , Mm          , Mm          , Re          , Re          , Mm          , Mm          , Mm          , Mm          
Mm          , Mm          , Mm          , Mm          , Hh          , Hh^Fp       , Hh^Fp       , Hh^Fp       , Gg          , Gg          , Gg          , Gg          , Gg^Ve       , Gs^Fp       , Gs^Fp       , Ww          , Gs^Fp       , Ds          , Ww          , Ww          , Gs^Fp       , Gg^Ve       , Gs^Fp       , Gll^Fp      , Hh          , Mm          , Mm          , Mm          , Mm          , Mm          , Mm          , Mm          , Mm          , Mm          , Mm          , Mm          , Mm          , Mm          , Mm          , Mm          , Re          , Mm          , Mm          , Mm          , Mm          
Mm          , Mm          , Mm          , Hh          , Hh^Fp       , Hh^Fp       , Gg          , Gg          , Gg          , Gg          , Gg          , Gg          , Gs^Fp       , Gs^Fp       , Ww          , Ww          , Gs^Fp       , Gg          , Ww          , Ww          , Gs^Fp       , Gs^Fp       , Gs^Fp       , Gs^Fp       , Hh          , Hh          , Hh          , Mm          , Mm          , Mm          , Mm          , Mm          , Mm          , Mm          , Mm          , Mm          , Mm          , Mm          , Mm          , Mm          , Re          , Mm          , Mm          , Mm          , Mm          
Mm          , Mm          , Mm          , Hh^Fp       , Gg          , Gg          , Gg          , Gg          , Gg          , Gg          , Gg          , Gs^Fp       , Gs^Fp       , Ww          , Ww          , Gs^Fp       , Gg^Ve       , Ds          , Ww          , Ww          , Ww          , Ds          , Ds          , Gs^Fp       , Gs^Fp       , Hh          , Hh          , Mm          , Mm          , Mm          , Mm          , Mm          , Mm          , Mm          , Mm          , Mm          , Mm          , Mm          , Mm          , Mm          , Re          , Mm          , Mm          , Mm          , Mm          
Hh          , Mm          , Hh^Fp       , Hh^Fp       , Gg          , Gg          , Gg          , Gg          , Gg          , Gg          , Gg          , Ds          , Ww          , Ww          , Ww          , Ds          , Ww          , Ww          , Ds          , Ww          , Ww          , Ww          , Gll^Fp      , Gg^Ve       , Hh^Fp       , Gs^Fp       , Hh          , Mm          , Mm          , Mm          , Mm          , Mm          , Mm          , Mm          , Mm          , Mm          , Mm          , Mm          , Mm          , Mm          , Re          , Mm          , Mm          , Mm          , Mm          
Hh          , Hh^Fp       , Hh^Fp       , Hh^Fp       , Gg          , Gg          , Gs^Fp       , Gg          , Ds          , Ds          , Ww          , Ww          , Ww          , Ww          , Ds          , Ww          , Gg          , Ww          , Gs^Fp       , Gs^Fp       , Gll^Fp      , Gll^Fp      , Gs^Fp       , Gs^Fp       , Hh^Fp       , Hh^Fp       , Mm          , Mm^Vhh      , Mm          , Mm          , Mm          , Mm          , Mm          , Mm          , Mm          , Mm          , Mm          , Mm          , Mm          , Mm          , Mm          , Re          , Re          , Mm          , Mm          
Hh          , Hh^Fp       , Gg          , Gg          , Ww          , Ww          , Ww          , Ww          , Ww          , Ww          , Ww          , Ww          , Gg          , Ds          , Gg          , Ds          , Gs^Fp       , Gll^Fp      , Hh^Fp       , Gll^Fp      , Hh^Fp       , Gll^Fp      , Hh^Fp       , Hh^Fp       , Mm          , Mm          , Mm          , Mm          , Mm          , Mm          , Mm          , Mm          , Mm          , Mm          , Mm          , Mm          , Mm          , Mm          , Mm          , Mm          , Mm          , Mm          , Mm          , Re          , Re          
