border_size=1
usage=map

Gs          , Rd          , Gs          , Gs          , Gs          , Gs          , Gd^Fdf      , Gd^Fdf      , Hhd^Fdf     , Mm          , Mm          , Mm          , Mm          , Mm          , Mm          , Mm          , Mm          , Mm          , Mm          , Mm          , Mm          , Mm          , Mm          , Mm          , Mm          , Mm          , Mm          , Mm          , Mm          , Mm          , Mm          , Mm          
Gs          , Rd          , Gs          , Gs          , Gs          , Gd^Fdf      , Gd^Fdf      , Gd^Fdf      , Mm          , Mm          , Mm          , Mm          , Hhd^Vhhr    , Mm          , Mm          , Mm          , Mm          , Mm          , Mm          , Mm          , Mm          , Mm          , Mm          , Mm          , Hhd         , Mm          , Mm          , Mm          , Mm          , Mm          , Mm          , Mm          
Gs          , Rd          , Gs          , Gs          , Gs          , Gd^Fdf      , Gs          , Gd^Fdf      , Mm          , Mm          , Mm          , Mm          , Mm          , Mm          , Mm          , Mm          , Mm          , Mm          , Mm          , Mm          , Mm          , Mm          , Mm          , Hhd^Vhhr    , Mm          , Mm          , Chr         , Chr         , Chr         , Mm          , Mm          , Mm          
Gd^Fdf      , Rd          , Rd          , Gs          , Gs          , Gs          , Gs          , Hhd         , Hhd         , Mm          , Mm          , Mm          , Mm          , Mm          , Mm          , Mm          , Mm          , Mm          , Mm          , Mm          , Mm          , Mm          , Mm          , Mm          , Hhd         , Hhd         , Chr         , 5 Khr       , Chr         , Hhd         , Mm          , Mm          
Gd^Fdf      , Gd^Fdf      , Gd^Fdf      , Rd          , Rd          , Gs          , Gs          , Gs          , Chr         , Mm          , Mm          , Mm          , Mm          , Mm          , Mm          , Mm          , Mm          , Mm          , Mm          , Mm          , Hhd         , Mm          , Hhd         , Hhd         , Gd^Vhr      , Gd          , Re          , Chr         , Hhd         , Hhd         , Mm          , Mm          
Mm          , Gd^Fdf      , Hhd^Fdf     , Hhd         , Hhd         , Rd          , Rr          , Rr          , Rr          , Mm          , Mm          , Mm          , Mm          , Mm          , Mm          , Mm          , Mm          , Mm          , Hhd         , Hhd         , Hhd         , Hhd         , Hhd         , Gd          , Re          , Re          , Gd          , Hhd         , Mm          , Mm          , Mm          , Mm          
Mm          , Hhd^Fdf     , Mm          , Mm          , Mm          , Hhd         , Hhd         , Chr         , Mm          , Re          , Re          , Mm          , Re          , Re          , Re          , Mm          , Hhd         , Hhd         , Ss          , Hhd         , Gd          , Gd          , Gd          , Gd          , Re          , Gd          , Gd^Vhr      , Hhd         , Mm          , Mm          , Mm          , Mm          
Mm          , Mm          , Mm          , Mm          , Mm          , Mm          , Mm          , Mm          , Mm          , Mm          , Mm          , Re          , Mm          , Mm          , Mm          , Re          , Re          , Re          , Re          , Re          , Re          , Re          , Re          , Re          , Ss          , Gd          , Hhd         , Hhd         , Mm          , Mm          , Mm          , Mm          
Mm          , Mm          , Mm          , Mm          , Mm          , Mm          , Mm          , Mm          , Mm          , Mm          , Mm          , Mm          , Mm          , Mm          , Mm          , Hhd         , Gd^Fdf      , Gd^Fdf      , Gd^Fdf      , Ss          , Ss          , Ss          , Re          , Re          , Ss          , Ss          , Hhd^Fdf     , Hhd         , Mm          , Mm          , Mm          , Mm          
Mm          , Mm          , Mm          , Mm          , Mm          , Mm          , Mm          , Mm          , Mm          , Mm          , Mm          , Mm          , Mm          , Mm          , Mm          , Hhd         , Gd^Fdf      , Gd^Fdf      , Gd^Vhr      , Ss          , Re          , Re          , Ss          , Ss          , Hhd^Fdf     , Hhd^Fdf     , Hhd^Fdf     , Mm          , Mm          , Mm          , Mm          , Mm          
Mm          , Mm          , Mm          , Mm          , Hhd^Vhhr    , Mm          , Mm          , Mm          , Mm          , Mm          , Mm          , Mm          , Mm          , Mm          , Mm          , Mm          , Hhd         , Gd          , Re          , Re          , Hhd         , Hhd         , Hhd         , Hhd         , Mm          , Mm          , Mm          , Mm          , Mm          , Mm          , Mm          , Mm          
Mm          , Mm          , Mm          , Mm          , Mm          , Mm          , Mm          , Mm          , Mm          , Mm          , Mm          , Mm          , Mm          , Mm          , Gd^Fdf      , Hhd         , Gd          , Gd          , Re          , Hhd         , Hhd         , Mm          , Mm          , Mm          , Mm          , Mm          , Mm          , Mm          , Mm          , Mm          , Mm          , Mm          
Mm          , Mm          , Mm          , Mm          , Mm          , Mm          , Mm          , Mm          , Mm          , Mm          , Mm          , Mm          , Hh          , Mm          , Gd^Fmf      , Gd^Fdf      , Gd^Fdf      , Gd          , Re          , Hhd         , Hhd         , Mm          , Mm          , Mm          , Mm          , Mm          , Mm          , Mm          , Mm          , Mm          , Mm          , Mm          
Mm          , Mm          , Mm          , Mm          , Mm          , Mm          , Mm          , Mm          , Mm          , Mm          , Hh          , Hh          , Gd          , Hh          , Gd^Fmf      , Gd^Fmf      , Gd          , Gd          , Re          , Hhd         , Mm          , Mm          , Mm          , Mm          , Mm          , Mm          , Mm          , Mm          , Hhd^Vhhr    , Mm          , Mm          , Mm          
Mm          , Mm          , Mm          , Mm          , Mm          , Mm          , Mm          , Mm          , Hh          , Hh          , Gd          , Gd          , Re          , Gd          , Gd          , Gd^Fmf      , Re          , Re          , Hh          , Gd^Vhr      , Mm          , Mm          , Mm          , Mm          , Mm          , Mm          , Mm          , Mm          , Mm          , Mm          , Mm          , Mm          
Mm          , Mm          , Mm          , Mm          , Mm          , Mm          , Mm          , Hh          , Gd          , Gd^Vhr      , Re          , Re          , Gd          , Re          , Re          , Re          , Hh          , Hh          , Mm          , Mm          , Mm          , Mm          , Mm          , Mm          , Mm          , Mm          , Mm          , Mm          , Mm          , Mm          , Mm          , Mm          
Mm          , Mm          , Mm          , Mm          , Mm          , Mm          , Mm          , Gs^Fdf      , Gd^Fmf      , Re          , Gd          , Gd          , Hh          , Gd^Vhr      , Hh          , Hh          , Mm          , Mm          , Mm          , Mm          , Mm          , Mm          , Mm          , Mm          , Mm          , Mm          , Mm          , Mm          , Mm          , Mm          , Mm          , Mm          
Mm          , Mm          , Mm          , Mm          , Hh^Fdf      , Hh^Fdf      , Gd^Fdf      , Gd^Fmf      , Re          , Re          , Hh          , Hh          , Mm          , Hh          , Mm          , Mm          , Mm          , Mm          , Mm          , Mm          , Mm          , Mm          , Mm          , Mm          , Mm          , Hh          , Hh^Fp       , Mm          , Mm          , Mm          , Mm          , Mm          
Mm          , Mm          , Hh          , Hh          , Hh^Fdf      , Gs^Fmf      , Gs^Fmf      , Re          , Gd^Vhr      , Gd          , Mm          , Mm          , Mm          , Mm          , Mm          , Mm          , Mm          , Mm          , Mm          , Mm          , Mm          , Mm          , Mm          , Mm          , Wwg         , Wwg         , Wwg         , Hh^Fp       , Mm          , Mm          , Mm          , Mm          
Mm          , Mm          , Hh          , Hh          , Hh          , Gs^Fdf      , Re          , Re          , Gd          , Gs          , Mm          , Mm          , Mm          , Mm          , Mm          , Mm          , Hhd^Vhhr    , Mm          , Mm          , Mm          , Mm          , Mm          , Mm          , Mm          , Wwg         , Ww          , Wwg         , Hhd^Vhhr    , Mm          , Mm          , Mm          , Mm          
Mm          , Mm          , Hh          , Hh          , Hh          , Gd^Vhr      , Re          , Gs          , Hh          , Hh          , Mm          , Mm          , Mm          , Mm          , Mm          , Mm          , Mm          , Mm          , Mm          , Mm          , Mm          , Mm          , Mm          , Mm          , Hh^Fp       , Wwg         , Mm          , Mm          , Mm          , Mm          , Mm          , Mm          
Mm          , Mm          , Hh          , Hh          , Hh          , Hh          , Re          , Re          , Hh          , Mm          , Mm          , Mm          , Mm          , Mm          , Mm          , Mm          , Mm          , Mm          , Mm          , Mm          , Mm          , Mm          , Hh^Fp       , Hh^Fp       , Wwg         , Wwg         , Mm          , Mm          , Mm          , Mm          , Mm          , Mm          
Mm          , Mm          , Mm          , Hh          , Hh          , Gd^Vhr      , Rr          , Re          , Ch          , Mm          , Mm          , Mm          , Mm          , Mm          , Mm          , Mm          , Mm          , Mm          , Mm          , Mm          , Mm          , Mm          , Hhd^Vhhr    , Wwg         , Hh^Fp       , Mm          , Mm          , Mm          , Mm          , Mm          , Mm          , Mm          
Mm          , Mm          , Mm          , Mm          , Hh          , Rr          , Ch          , Rr          , Rr          , Hh          , Gs^Fmf      , Hh^Fmf      , Gs^Fdf      , Hh^Fdf      , Hh^Fmf      , Mm          , Mm          , Mm          , Mm          , Mm          , Mm          , Mm          , Mm          , Hh^Fp       , Hh          , Mm          , Mm          , Mm          , Mm          , Mm          , Mm          , Mm          
Mm          , Mm          , Mm          , Mm          , Mm          , Mm          , Hh          , Gs^Fmf      , Gd^Fmw      , Rd          , Rd          , Gs^Fmw      , Gd^Fmf      , Gs^Fmf      , Hh          , Hh          , Hh          , Mm          , Mm          , Mm          , Mm          , Mm          , Mm          , Mm          , Mm          , Mm          , 4 Ke        , Mm          , Mm          , Hhd^Vhhr    , Mm          , Mm          
Mm          , Mm          , Mm          , Mm          , Mm          , Mm          , Hh          , Hh^Fmf      , Gd^Fmf      , Gd^Fmf      , Gd          , Rd          , Rd          , Gd^Vhr      , Gs          , Hh          , Hh          , Hh          , Mm          , Mm          , Mm          , Mm          , Mm          , Mm          , Mm          , Mm          , Mm          , Ce          , Mm          , Mm          , Mm          , Mm          
Mm          , Mm          , Mm          , Mm          , Mm          , Mm          , Mm          , Hh^Fmf      , Hh          , Gd^Fmw      , Hh          , Gs          , Gs          , Rd          , Gs          , Gs          , Hh          , Hh          , Hhd^Vhhr    , Mm          , Mm          , Mm          , Mm          , Mm          , Mm          , Mm          , Mm          , Mm          , Mm          , Mm          , Mm          , Mm          
Mm          , Mm          , Mm          , Mm          , Mm          , Mm          , Mm          , Mm          , Mm          , Hh          , Hh          , Hh          , Gs          , Rd          , Rd          , Gs          , Hh          , Hh          , Mm          , Mm          , Mm          , Mm          , Mm          , Mm          , Mm          , Mm          , Mm          , Mm          , Mm          , Mm          , Mm          , Mm          
Mm          , Mm          , Mm          , Hhd^Vhhr    , Mm          , Mm          , Mm          , Mm          , Mm          , Mm          , Mm          , Mm          , Hh          , Gs          , Rd          , Gs          , Hh          , Mm          , Mm          , Mm          , Mm          , Mm          , Mm          , Mm          , Mm          , Mm          , Mm          , Mm          , Mm          , Mm          , Mm          , Mm          
Mm          , Mm          , Mm          , Mm          , Mm          , Mm          , Mm          , Mm          , Mm          , Mm          , Mm          , Hh          , Hh^Fmw      , Gs^Fmw      , Rd          , Gs          , Hh          , Mm          , Mm          , Mm          , Mm          , Mm          , Mm          , Mm          , Mm          , Hhd^Vhhr    , Mm          , Mm          , Mm          , Mm          , Mm          , Mm          
Mm          , Mm          , Mm          , Mm          , Mm          , Mm          , Mm          , Mm          , Mm          , Mm          , Mm          , Hh          , Hh          , Gs^Fmf      , Rd          , Gs          , Hh          , Mm          , Mm          , Mm          , Mm          , Mm          , Mm          , Mm          , Mm          , Mm          , Mm          , Mm          , Mm          , Mm          , Mm          , Mm          
Mm          , Mm          , Mm          , Mm          , Mm          , Mm          , Mm          , Mm          , Mm          , Mm          , Mm          , Hh          , Hh          , Gs^Fdf      , Rd          , Gd^Vhr      , Gs^Fmf      , Hh          , Mm          , Mm          , Mm          , Mm          , Mm          , Mm          , Mm          , Mm          , Hh          , Mm          , Mm          , Mm          , Mm          , Mm          
Mm          , Mm          , Mm          , Mm          , Mm          , Mm          , Mm          , Hhd^Vhhr    , Mm          , Mm          , Mm          , Mm          , Hh          , Gs          , Rd          , Gs^Fmw      , Hh          , Hh          , Mm          , Mm          , Mm          , Mm          , Mm          , Mm          , Mm          , Mm          , Hh          , Hhd^Vhhr    , Mm          , Mm          , Mm          , Mm          
Mm          , Mm          , Mm          , Mm          , Mm          , Mm          , Mm          , Mm          , Ce          , Mm          , Mm          , Mm          , Hh          , Gs          , Rd          , Gs          , Hh          , Hh          , Hh          , Mm          , Hh          , Mm          , Mm          , Mm          , Mm          , Hh          , Hh          , Hh          , Mm          , Mm          , Mm          , Mm          
Mm          , Mm          , Mm          , Mm          , Mm          , Mm          , Mm          , Mm          , 3 Ke        , Ce          , Mm          , Mm          , Hh          , Gd^Vhr      , Rd          , Gs          , Gs          , Hh          , Hh          , Mm          , Chr         , Hh          , Hh          , Mm          , Hh^Fmw      , Hh^Fmw      , Gd^Vhr      , Hh          , Mm          , Mm          , Mm          , Mm          
Mm          , Mm          , Hh          , Mm          , Mm          , Mm          , Mm          , Mm          , Mm          , Ce          , Mm          , Mm          , Mm          , Hh          , Hh          , Rd          , Rd          , Gs          , Rr          , 2 Khr       , Chr         , Hh          , Hh          , Hh          , Gd^Vhr      , Gs^Fmw      , Gs^Fmf      , Hh          , Mm          , Mm          , Mm          , Mm          
Mm          , Mm          , Mm          , Mm          , Mm          , Mm          , Mm          , Mm          , Mm          , Mm          , Mm          , Mm          , Mm          , Mm          , Mm          , Hh          , Hh          , Rd          , Rr          , Chr         , Rd          , Gs          , Gs          , Hh          , Gd^Fmw      , Gd^Fmf      , Gs^Fdf      , Hh          , Hh          , Mm          , Mm          , Mm          
Mm          , Mm          , Mm          , Mm          , Hhd^Vhhr    , Mm          , Mm          , Mm          , Mm          , Mm          , Mm          , Mm          , Mm          , Mm          , Mm          , Mm          , Hh          , Chr         , Rd          , Rd          , Rd          , Rd          , Rd          , Rd          , Rd          , Gd^Fdf      , Gs^Fdf      , Gs          , Ce          , Ce          , Ce          , Mm          
Hh          , Hh          , Mm          , Mm          , Mm          , Mm          , Mm          , Mm          , Mm          , Mm          , Mm          , Mm          , Mm          , Mm          , Mm          , Mm          , Mm          , Hh          , Hh          , Hh          , Hh          , Rd          , Hh          , Rd          , Gs^Fdf      , Rd          , Rd          , Gs          , Ce          , 1 Ke        , Ce          , Mm          
Mm          , Mm          , Mm          , Mm          , Mm          , Mm          , Mm          , Mm          , Mm          , Mm          , Mm          , Mm          , Mm          , Mm          , Hh          , Hh          , Mm          , Mm          , Mm          , Mm          , Mm          , Hh          , Hh          , Hh          , Hh          , Gs^Fmf      , Gs^Fdf      , Rd          , Rd          , Ce          , Hh          , Mm          
Mm          , Mm          , Mm          , Mm          , Mm          , Mm          , Mm          , Mm          , Mm          , Hhd^Vhhr    , Mm          , Mm          , Mm          , Mm          , Mm          , Mm          , Mm          , Mm          , Mm          , Mm          , Mm          , Mm          , Mm          , Mm          , Mm          , Hh          , Hh          , Gd^Vhr      , Hh          , Rd          , Rd          , Mm          
Mm          , Mm          , Mm          , Mm          , Mm          , Mm          , Mm          , Mm          , Mm          , Mm          , Mm          , Mm          , Mm          , Mm          , Mm          , Mm          , Mm          , Mm          , Mm          , Mm          , Mm          , Mm          , Mm          , Mm          , Mm          , Mm          , Mm          , Hh          , Mm          , Mm          , Mm          , Rd          
