border_size=1
usage=map

Ww          , Ww          , Ww          , Ww          , Ww          , Ww          , Wo          , Wo          , Wo          , Wo          , Wo          , Wo          , Wo          , Wo          , Wo          , Wo          , Wo          , Wo          , Wo          , Wo          , Wo          , Wo          , Wo          
Gg          , Ds          , Ww          , Wwr         , Ww          , Wwr         , Wo          , Wo          , Wo          , Wo          , Wo          , Wo          , Wo          , Wo          , Wo          , Wo          , Wo          , Wo          , Wo          , Wo          , Wo          , Wo          , Wo          
Gg          , Gs          , Ds          , Ds          , Wwr         , Ds          , Wwr         , Wwr         , Wo          , Wo          , Wo          , Wo          , Wo          , Wo          , Wo          , Wo          , Wo          , Wo          , Wo          , Wo          , Wo          , Wo          , Wo          
Gg          , Gs          , Gs          , Gg^Vc       , Ds          , Gs          , Ds          , Ww          , Ww          , Ww          , Ww^Vm       , Wwr         , Wo          , Wo          , Wo          , Wo          , Wo          , Wo          , Wo          , Wo          , Wo          , Wo          , Wo          
Hh          , Gg          , Gg          , Gg          , Gg          , Gg          , Ds          , Ds          , Ww          , Ww          , Wwr         , Wwr         , Wwr         , Wo          , Wo          , Wo          , Wo          , Wo          , Wo          , Wo          , Wo          , Wo          , Ww          
Mm          , Hh          , Hh          , Hh          , Gg          , Gg          , Gs          , Gs          , Ww          , Ww          , Ww          , Ww          , Wwr         , Wwr         , Wo          , Wo          , Wo          , Wo          , Wo          , Wo          , Wo          , Ww          , Wwr         
Mm          , Mm          , Mm          , Mm          , Hh^Fp       , Gs^Fms      , Gg          , Gs          , Ds          , Ww          , Ds          , Ww          , Ww          , Ww          , Wo          , Wo          , Wo          , Wo          , Wo          , Wo          , Wo          , Ww          , Wwr         
Mm          , Mm          , Mm          , Mm          , Hh^Fp       , Hh          , Gg          , Gs          , Gs          , Ds          , Ww          , Dd^Vda      , Wwr         , Wwr         , Wo          , Wo          , Wo          , Wo          , Wo          , Wo          , Wo          , Wo          , Ww          
Mm          , Mm          , Mm          , Ww          , Mm          , Re^Gvs      , Re^Gvs      , Re^Gvs      , Gg          , Ww          , Ww          , Dd          , Dd          , Wwr         , Ww          , Ww          , Wo          , Wo          , Wo          , Wo          , Wo          , Wo          , Wo          
Hh          , Mm          , Mm          , Mm          , Gg^Ve       , Re^Gvs      , Re^Gvs      , Gg          , Gs          , Ww          , Dd          , Hd          , Dd          , Dd          , Wwr         , Ww          , Wwr         , Wwr         , Wo          , Wo          , Wo          , Wo          , Wo          
Hh          , Hh          , Mm          , Mm          , Mm          , Ww          , Gg          , Ww          , Ww          , Gs^Ft       , Gs^Ft       , Dd          , Dd          , Dd          , Wwr         , Ww          , Wwr         , Wwr         , Wwr         , Wo          , Wo          , Wo          , Wo          
Mm          , Mm          , Hh          , Ww          , Ww          , Gg          , Ww          , Gs^Fp       , Ww          , Dd          , Dd          , Gs^Ft       , Dd          , Dd          , Dd          , Dd          , Ww          , Ww          , Wwr         , Ww          , Wwr         , Ww^Vm       , Wo          
Mm          , Mm          , Mm          , Mm          , Mm          , Gs^Fp       , Gs^Fp       , Gs^Fds      , Ww          , Ww^Bw|      , Ww          , Ww          , Gs^Ft       , Ss          , Dd          , Dd          , Dd          , Ww          , Ww          , Ww          , Wwr         , Wo          , Wo          
Mm          , Mm          , Mm          , Mm          , Mm          , Mm          , Gs^Fms      , Gs^Fms      , Gg          , Rd          , Hh          , Mm          , Ww          , Mm          , Gs^Ft       , Dd^Vda      , Dd          , Ww          , Ww          , Ww          , Wwr         , Wo          , Wo          
Hh          , Mm          , Mm          , Mm          , Mm          , Hh^Vhh      , Gs^Fp       , Rd          , Rd          , Gs^Fp       , Hh^Fp       , Mm          , Mm          , Gs          , Gs          , Ds          , Ds          , Ds          , Ww          , Wwr         , Wwr         , Wo          , Wo          
Mm          , Hh          , Ww          , Ww          , Mm          , Hh^Fp       , Rd          , Gs          , Gs^Fp       , Gs^Fp       , Hh^Fp       , Gg^Efm      , Mm          , Gs          , Ds          , Ds          , Ds          , Ww          , Ww          , Wwr         , Wwr         , Wo          , Wo          
Mm          , Mm          , Ww          , Mm          , Ww          , Ww          , Gg          , Ww          , Gs          , Gg          , Gg^Efm      , Ss          , Gg^Efm      , Gs          , Dd          , Ds          , Ds          , Ww          , Ww          , Wwr         , Wwr         , Wo          , Wo          
Mm          , Mm          , Mm          , Mm          , Mm          , Hh^Fp       , Ww          , Gs^Fp       , Ww          , Ww          , Ss          , Ss          , Chr         , Ww          , Dd          , Ds          , Ds          , Ww          , Ww          , Wwr         , Wwr         , Wo          , Wo          
Mm          , Mm          , Mm          , Mm          , Mm          , Hh^Fp       , Gs^Fp       , Gs^Fp       , Gs          , Ww          , Ss          , 2 Chs       , Khs         , Ds          , Ww          , Ds          , Ww          , Ww          , Ww          , Ww          , Ww          , Wo          , Wo          
Hh          , Mm          , Mm          , Ww          , Ww          , Ww          , Ww          , Ww          , Gs          , Ww          , Ss          , Chs         , Ds          , Ds          , Ww          , Ww          , Ww          , Wwr         , Ww          , Wo          , Wo          , Wo          , Wo          
Gg          , Ww          , Ww          , Gs^Fms      , Gs^Fp       , Gg          , Gs^Fms      , Gs          , Ww          , Ww          , Ds          , Ds          , Ds          , Ww          , Ww          , Wwr         , Wwr         , Wwr         , Wwr         , Wo          , Wo          , Wo          , Wo          
Gg          , Hh          , Hh^Vhh      , Rd          , Gg          , Gs          , Gs          , Ds          , Ds          , Ds          , Ww          , Ww          , Ww          , Wwr         , Ww          , Wwr         , Wwr         , Ww          , Wo          , Wo          , Wo          , Wo          , Wo          
Gg          , Gs^Fp       , Gs^Fp       , Rd          , Gs^Fp       , Rd          , Gs          , Gs^Vht      , Ds          , Wwr         , Wwr         , Wwr         , Wwr         , Wwr         , Wwr         , Ww          , Ww          , Wo          , Wo          , Wo          , Wo          , Wo          , Wo          
Gg          , Gg          , Gg          , Gs          , Rd          , Gs          , Rd          , Dd          , Wwr         , Ww          , Ww          , Ww          , Wwr         , Wo          , Ww          , Wo          , Ww          , Wo          , Wo          , Wo          , Wo          , Wo          , Wo          
Ds          , Ds          , Gs          , Ww          , Dd          , Dd          , Dd          , Ww          , Ww          , Wo          , Wo          , Wo          , Wo          , Wo          , Wo          , Wo          , Wwr         , Wwr         , Wwr         , Ww          , Wo          , Wo          , Wo          
Ds          , Ww          , Ds          , Ww          , Ww          , Ww          , Ww          , Wwr         , Wo          , Wo          , Wo          , Wo          , Wo          , Wo          , Wo          , Wo          , Wo          , Wo          , Ww^Vm       , Ww          , Wo          , Wo          , Wo          
Ww          , Ww          , Ww          , Ww          , Ww          , Wwr         , Wwr         , Wwr         , Wo          , Wo          , Wo          , Wo          , Wo          , Wo          , Wo          , Wo          , Wo          , Wo          , Ww          , Wo          , Wo          , Wo          , Wo          
Ww          , Wo          , Wo          , Wo          , Wo          , Wo          , Wwr         , Ww^Vm       , Wo          , Wo          , Wo          , Wo          , Wo          , Wo          , Wo          , Wo          , Wo          , Wo          , Wo          , Wo          , Wo          , Wo          , Wo          
Ww          , Wo          , Wo          , Wo          , Wo          , Wo          , Wo          , Wo          , Wo          , Wo          , Wo          , Wo          , Wo          , Wo          , Wo          , Wo          , Wo          , Wo          , Wo          , Wo          , Wo          , Wo          , Wo          
Ww          , Wo          , Wo          , Wo          , Wo          , Wo          , Wo          , Wo          , Wo          , Wo          , Wo          , Wo          , Wo          , Wo          , Wo          , Wo          , Wo          , Wo          , Wo          , Wo          , Wo          , Wo          , Wo          
