border_size=1
usage=map

Dd          , Hd          , Dd          , Dd          , Ds          , Wwt         , Wwt         , Wwt         , Wwt         , Wwt         , Wwt         , Wwt         , Wwt         , Wwt         , Wwf         , Wwf         , Wwf         , Wwt         , Wwt         , Wwt         , Wwt         , Wwt         , Wwt         , Wwt         , Wwr         , Wwr         , Wwr         , Wwr         , Wwt         
Md          , Dd^Do       , Gs          , Gs          , Ds          , Wwt         , Wwt         , Wwt         , Wwt         , Wwf         , Wwf         , Wwt         , Wwt         , Wwt         , Wwf         , Wwf         , Wwr         , Wwt         , Wwt         , Ww^Vm       , Wwt         , Ww^Vm       , Wwt         , Wwt         , Wwf         , Ww          , Ww          , Wwr         , Ds          
Md          , Md          , Dd          , Dd          , Dd          , Wwt         , Wwt         , Wwr         , Wwr         , Wwt         , Wwt         , Wwt         , Wwt         , Wwt         , Wwt         , Wwr         , Wwr         , Wwt         , Wwt         , Wwt         , Wwt         , Wwt         , Wwt         , Wwt         , Wwf         , Ww          , Ww          , Ww          , Ds          
Md          , Md          , Md          , Wwt         , Wwt         , Ds          , Wwt         , Wwt         , Wwr         , Wwt         , Ds          , Wwf         , Wwf         , Wwt         , Wwt         , Wwr         , Wwt         , Wwt         , Ds          , Ds          , Wwt         , Wwt         , Wwt         , Wwt         , Wwf         , Wwf         , Wwf         , Wwf         , Wwt         
Md          , Hd          , Dd          , Dd          , Dd          , Wwt         , Wwt         , Wwr         , Wwt         , Ds          , Ds          , Wwf         , Wwf         , Wwf         , Ww^Vm       , Wwt         , Ds          , Ds          , Chw         , Chw         , 2 Khw       , Chw         , Chw         , Wwt         , Wwt         , Wwt         , Ww^Vm       , Wwt         , Wwt         
Hd          , Hd          , Dd          , Dd^Do       , Dd          , Wwt         , Wwt         , Wwr         , Wwt         , Wwt         , Wwt         , Wwf         , Wwt         , Wwt         , Wwt         , Wwt         , Wwt         , Ds          , Ds          , Chw         , Wwt         , Chw         , Wwt         , Wwt         , Wwt         , Wwt         , Wwt         , Wwt         , Wwt         
Dd          , Dd          , Gs          , Dd^Vdt      , Ds          , Wwt         , Wwf         , Wwr         , Wwt         , Wwt         , Wwt         , Wwt         , Wwt         , Wwt         , Wwt         , Wwt         , Wwt         , Wwt         , Ds          , Ds          , Ds          , Wwt         , Wwt         , Wwt         , Wwt         , Wwt         , Wwt         , Wwt         , Wwt         
Wwt         , Gs          , Gs          , Gs          , Ds          , Ds          , Wwt         , Wwt         , Wwt         , Wwt         , Wwt         , Wwt         , Wwt         , Wwt         , Wwt         , Wwt         , Wwt         , Wwt         , Wwt         , Wwt         , Wwt         , Wwt         , Wwt         , Wwt         , Wwt         , Wwt         , Wwr         , Wwt         , Wwt         
Gs^Ft       , Wwt         , Wwt^Bw|     , Gg          , Gg          , Ds          , Wwt         , Wwt         , Wwt         , Wwt         , Wwt         , Wwt         , Wwr         , Wwr         , Wwr         , Wwt         , Wwt         , Wwt         , Wwt         , Ww^Vm       , Wwt         , Ww^Vm       , Wwt         , Wwt         , Wwr         , Wwr         , Wwr         , Wwr         , Wwr         
Gs^Ft       , Gs^Ft       , Gg^Efm      , Wwt         , Wwt         , Wwt         , Ds          , Wwt         , Wwt         , Wwt         , Wwt         , Wwt         , Wwt         , Wwr         , Wwt         , Wwt         , Wwt         , Wwt         , Wwf         , Wwf         , Wwf         , Wwt         , Wwt         , Wwt         , Wwt         , Wwt         , Wwt         , Wwf         , Wwf         
Gs^Ft       , Gs^Ft       , Ss          , Gs^Vl       , Wwt         , Gg          , Gs          , Ds          , Wwt         , Wwt         , Wwt         , Wwt         , Wwr         , Wwr         , Wwr         , Wwr         , Wwf         , Wwf         , Wwt         , Wwt         , Wwt         , Wwt         , Wwt         , Wwt         , Wwt         , Wwt         , Wwf         , Wwt         , Wwf         
Gs^Ft       , Gs^Ft       , Gs^Ft       , Wwt         , Gs^Ft       , Gs          , Gs^Ft       , Ds          , Wwt         , Ww^Vm       , Wwt         , Wwt         , Wwt         , Wwr         , Wwt         , Wwt         , Wwt         , Wwf         , Wwt         , Wwt         , Wwt         , Ds          , Ds^Es       , Ds          , Wwt         , Wwf         , Wwf         , Wwf         , Wwf         
Gs^Ft       , Gs^Ft       , Gs^Ft       , Gs          , Gs^Ft       , Gs          , Gs^Ft       , Gs^Ft       , Ds          , Wwt         , Wwf         , Wwf         , Wwf         , Wwt         , Wwt         , Wwt         , Wwt         , Wwt         , Wwt         , Wwt         , Wwt         , Ds          , Wwt         , Wwt         , Wwt         , Wwt         , Wwt         , Wwt         , Ds          
Gs^Ft       , Gs^Ft       , Wwt         , Wwt         , Gs^Ft       , Gs^Ft       , Gs^Ft       , Gs^Ft       , Gs          , Gs^Ft       , Gs^Ft       , Ds          , Ds          , Wwf         , Wwf         , Wwf         , Wwt         , Wwt         , Wwt         , Wwt         , Wwt         , Wwt         , Wwt         , Wwt         , Wwt         , Wwt         , Wwt         , Ss          , Gg          
Gs^Ft       , Gs^Ft       , Ss^Vhs      , Gg          , Gs^Ft       , Gs          , Ss          , Ss          , Gs^Ft       , Gs^Ft       , Gs^Ft       , Gs          , Gs^Ft       , Ds          , Ds          , Wwf         , Wwt         , Wwt         , Ds          , Wwt         , Wwt         , Wwt         , Wwt         , Wwt         , Wwt         , Wwt         , Wwt         , Ss          , Ss          
Gs^Ft       , Gs^Ft       , Ss          , Ss^Bw\      , Gs^Ft       , Ss          , Ss          , Gs^Ft       , Gs^Ft       , Gs^Ft       , Gs          , Gs^Ft       , Gs^Ft       , Gs          , Gs          , Ds          , Dd          , Ds          , Dd          , Ds          , Ds          , Ds          , Ds          , Ds          , Ss          , Wwt         , Wwt         , Wwt         , Wwt         
Gs^Ft       , Gs^Ft       , Ss          , Ss^Bw|      , Gs^Ft       , Chs         , Ss          , Gs^Ft       , Gs^Ft       , Gs          , Gs          , Gs^Ft       , Ss^Bw/      , Gs          , Gg          , Gg          , Gg^Efm      , Dd          , Dd^Do       , Dd          , Gs          , Ds^Edpp     , Gs          , Gs          , Ss          , Ss          , Ss          , Ss          , Ss          
Gs^Ft       , Gs^Ft       , Ss          , Ss^Bw|      , Ss          , Ss          , Gs^Ft       , Gs^Ft       , Gs^Ft       , Gs^Ft       , Ss^Bw|      , Ss^Bw/      , Ss          , Gs^Ft       , Gs^Ft       , Gs^Ft       , Ss          , Ss          , Gs^Ft       , Gg          , Gs^Ft       , Gs          , Gs          , Gg^Efm      , Gg^Efm      , Ss          , Ss          , Ss^Vm       , Ss          
Gs^Ft       , Gs^Ft       , Gs^Ft       , Chr         , Chr         , Ss          , Ss          , Gs^Ft       , Gs^Ft       , Gs^Ft       , Ss^Bw|      , Ss          , Ss          , Ss          , Ss          , Ss^Vm       , Ss          , Gs^Ft       , Gs^Ft       , Gs^Ft       , Gs^Ft       , Gs^Ft       , Gs^Ft       , Gs          , Gs          , Gg^Efm      , Gg^Efm      , Ss          , Hh          
Gs^Ft       , Gs^Ft       , Gs^Ft       , Chr         , 3 Khr       , Chs         , Ss^Bw\      , Ss          , Ss          , Ss          , Ss^Bw/      , Ss          , Ss          , Ss          , Ss          , Ss          , Ss          , Gs^Ft       , Gs^Ft       , Gs^Ft       , Gs^Ft       , Gs^Ft       , Gs^Ft       , Wwt         , Wwt         , Gs          , Gg          , Hh^Fp       , Hh          
Gs^Ft       , Gs^Ft       , Gs^Ft       , Ss          , Chr         , Chs         , Gs^Ft       , Ss^Bw\      , Ss^Bw\      , Ss^Bw/      , Ss          , Ss^Bw\      , Wwt         , Ww^Vm       , Ss          , Ss          , Gs^Ft       , Gs^Ft       , Ss          , Gs^Ft       , Ss          , Gs^Ft       , Gs^Ft       , Wwt         , Wwt         , Wwt         , Wwt         , Gg          , Wwt         
Gs^Ft       , Gs^Ft       , Gs^Ft       , Ss          , Ss          , Ss          , Ss          , Ss          , Gs^Ft       , Gs^Ft       , Ss          , Ss          , Ss          , Ss          , Gs^Ft       , Gs^Ft       , Gs^Ft       , Gs^Ft       , Gs^Ft       , Gg^Vc       , Ss          , Ss          , Gs^Ft       , Wwt         , Wwt         , Wwt         , Hh          , Wwt         , Wwt         
Gs^Ft       , Gs^Ft       , Gs^Ft       , Gs^Ft       , Gs^Ft       , Ss^Vhs      , Gs^Ft       , Gs^Ft       , Gs^Ft       , Gs^Ft       , Chs         , Chs         , Ss          , Ss          , Gs^Ft       , Gs^Ft       , Gs^Ft       , Gs^Ft       , Gs^Ft       , Gs^Ft       , Gs^Ft       , Gs^Ft       , Gs^Ft       , Gs^Ft       , Gs^Ft       , Gs          , Gs          , Ss^Vm       , Mm          
Gs^Ft       , Gs^Ft       , Gs^Ft       , Gs^Ft       , Gs^Ft       , Gs^Ft       , Gs^Ft       , Gs^Ft       , Gs^Ft       , Gs^Ft       , Gs^Ft       , Gs^Ft       , Gs^Ft       , Gs^Ft       , Gs^Ft       , Gs^Ft       , Gs^Ft       , Gs^Ft       , Gs^Ft       , Gs^Ft       , Gs^Ft       , Gs^Ft       , Gs^Ft       , Gs^Ft       , Gs^Ft       , Gs^Ft       , Gs          , Mm          , Mm          
