border_size=1
usage=map

Wo          , Wo          , Wo          , Wo          , Wo          , Wo          , Wo          , Wo          , Wo          , Wo          , Wo          , Wwt         , Wwt         , Wwt         , Ds          , Ds          , Hd          , Hd          , Hd          , Hd          , Hd          , Hd          , Hd          , Hd          , Hd          , Hd          , Hd          , Hd          , Hd          , Hd          , Hd          , Hd          , Hd          , Hd          , Hd          , Hd          , Dd          , Dd          , Dd          , Dd          , Dd          , Dd          , Dd          , Dd          , Dd          , Dd          , Dd          , Mm          , Mm          , Mm          , Md          , Md          , Md          , Md          , Md          , Md          , Md          
Wo          , Wo          , Wo          , Wo          , Wo          , Wo          , Wo          , Wo          , Wo          , Wo          , Wo          , Wo          , Wwt         , Wwt         , Wwt         , Ds          , Hd          , Hd          , Hd          , Hd          , Hd          , Hd^Esd      , Hd          , Hd          , Hd          , Dd^Do       , Hd          , Hd          , Hd          , Hd          , Co          , Co          , Co          , Hd          , Dd          , Dd          , Dd          , Dd          , Dd          , Dd          , Dd^Do       , Dd          , Dd          , Dd          , Dd          , Dd^Edpp     , Dd          , Dd          , Dd          , Mm          , Md          , Md          , Md          , Md          , Md          , Md          , Md          
Wo          , Wo          , Wo          , Wo          , Wo          , Wo          , Wo          , Wo          , Wo          , Wo          , Wo          , Wo          , Wo          , Wwt         , Wwt         , Ds          , Ds          , Hd          , Hd          , Hd          , Hd          , Hd          , Hd          , Hd          , Hd          , Hd          , Hd          , Hd          , Hd^Esd      , Hd          , Co          , 4 Ko        , Co          , Hd          , Dd          , Dd          , Dd^Edpp     , Dd          , Dd          , Dd          , Dd          , Dd          , Dd          , Dd          , Dd^Vda      , Dd          , Dd          , Dd          , Dd          , Mm          , Md          , Md          , Md          , Hhd^Vhhr    , Md          , Md          , Md          
Wo          , Wo          , Wo          , Wo          , Wo          , Wo          , Wo          , Wo          , Wo          , Wo          , Wo          , Wo          , Wo          , Wo          , Wo          , Wwt         , Wwt         , Ds          , Hd          , Hd          , Hd          , Hd          , Hd          , Hd          , Hd          , Hd          , Hd          , Hd          , Hd          , Hd          , Hd          , Co          , Hd          , Dd          , Dd          , Dd          , Dd          , Dd          , Dd          , Dd          , Dd          , Dd          , Dd          , Dd^Edpp     , Dd          , Dd          , Dd          , Dd          , Dd          , Mm          , Md          , Md          , Md          , Md          , Md          , Md          , Md          
Wo          , Wo          , Wo          , Wo          , Wo          , Wo          , Wo          , Wo          , Wo          , Wo          , Wo          , Wo          , Wo          , Wo          , Wo          , Wo          , Wwt         , Ds          , Hd          , Hd          , Hd          , Hd          , Hd          , Hd          , Hd          , Hd          , Hd          , Hd          , Hd          , Hd          , Hd          , Hd          , Hd          , Dd          , Dd          , Dd          , Dd          , Dd          , Dd          , Dd          , Dd          , Dd          , Dd          , Dd          , Dd          , Dd          , Dd          , Dd          , Dd          , Dd          , Md          , Md          , Md          , Md          , Md          , Md          , Md          
Wo          , Wo          , Wo          , Wo          , Wo          , Wo          , Wo          , Wo          , Wo          , Wo          , Wo          , Wo          , Wo          , Wo          , Wo          , Wo          , Wwt         , Ds          , Ds          , Dd^Vdt      , Hd          , Hd          , Hd          , Hd          , Hd          , Hd          , Wwt         , Hd          , Hd          , Hd          , Hd          , Hd          , Dd          , Dd          , Ds          , Ds          , Ds          , Dd          , Ds          , Dd          , Dd          , Dd          , Dd          , Dd          , Hd          , Hd          , Wwt         , Hd          , Dd          , Dd^Vda      , Dd          , Hd          , Hd          , Hd          , Hd          , Md          , Md          
Wo          , Wo          , Wo          , Wo          , Wo          , Wo          , Wo          , Wo          , Wo          , Wo          , Wwt         , Wo          , Wwt         , Wo          , Wwt         , Wwt         , Wwt         , Wwt         , Ch          , Hd          , Hd          , Hd          , Dd^Do       , Hd          , Hd          , Hd          , Hd          , Hd          , Dd          , Dd^Vda      , Dd          , Dd          , Wwt         , Wwt         , Wwt         , Wwt         , Wwt         , Ds          , Wwt         , Ds          , Ds          , Dd^Vdt      , Ds          , Dd          , Dd          , Dd          , Dd          , Dd          , Co          , Dd          , Dd          , Dd          , Dd          , Dd          , Hd          , Hd          , Md          
Wo          , Wo          , Wo          , Wo          , Wo          , Wo          , Wwr         , Wwr         , Wwr         , Wwt         , Wwt         , Wwt         , Ds          , Wwt         , Wwt         , Wwt         , Wwt         , Wwt         , Wwt         , Ch          , Dd          , Dd          , Dd          , Gs          , Dd          , Hd          , Dd          , Dd          , Wwt         , Dd^Do       , Wwt         , Wwt         , Wwt         , Wwt         , Wwt         , Wwt         , Wwt         , Wwt         , Wwt         , Wwf         , Wwf         , Ds          , Ds          , Ds          , Ds          , Dd          , Ds          , Co          , 6 Ko        , Co          , Dd          , Dd          , Dd^Dc       , Dd          , Dd          , Dd          , Ds          
Wo          , Wo          , Wo          , Wo          , Wo          , Wo          , Wo          , Wwr         , Wwt         , Wwt         , Wwt         , Wwt         , Ds          , Ds          , Dd          , Ch          , Ch          , Wwt         , Wwt         , Wwt         , Wwt         , Wwt         , Wwt         , Wwt         , Wwt         , Dd          , Dd          , Wwt         , Wwt         , Wwt         , Wwt         , Wwt         , Wwt         , Wwt         , Wwt         , Wwt         , Wwr         , Wwt         , Wwf         , Wwf         , Wwf         , Wwt         , Wwt         , Wwt         , Wwt         , Ds          , Ds          , Co          , Co          , Co          , Dd          , Dd          , Dd          , Dd          , Ds          , Dd^Vdt      , Dd          
Wo          , Wo          , Wo          , Wo          , Wo          , Wo          , Wo          , Wwr         , Wwt         , Wwt         , Wwt         , Wwt         , Dd          , Hd          , Dd          , Dd          , Ds          , Wwt         , Wwt         , Wwt         , Wwt         , Wwt         , Wwt         , Wwt         , Wwt         , Wwt         , Wwf         , Wwf         , Wwf         , Wwt         , Wwt         , Wwt         , Wwt         , Wwt         , Wwt         , Wwt         , Wwr         , Wwr         , Wwr         , Wwr         , Wwt         , Wwt         , Wwt         , Wwt         , Wwt         , Wwt         , Ds^Dr       , Ds          , Ds          , Ds          , Dd          , Dd          , Dd          , Dd          , Gs          , Hd          , Dd          
Wo          , Wo          , Wo          , Wo          , Wo          , Wo          , Wo          , Wwr         , Wwt         , Wwt         , Ds          , Ds          , Md          , Dd^Do       , Gs          , Gs          , Ds          , Wwt         , Wwt         , Wwt         , Wwt         , Wwf         , Wwf         , Wwt         , Wwt         , Wwt         , Wwf         , Wwf         , Wwf         , Wwt         , Wwt         , Ww^Vm       , Wwt         , Ww^Vm       , Wwt         , Wwt         , Wwt         , Wwt         , Wwt         , Wwr         , Ds          , Wwt         , Wwt         , Wwt         , Wwt         , Wwt         , Wwt         , Ds          , Ds          , Dd          , Wwt         , Wwt         , Gs          , Dd          , Md          , Dd^Do       , Dd          
Wo          , Wo          , Wo          , Wo          , Wo          , Wo          , Wwr         , Wwr         , Wwt         , Wwt         , Dd          , Hd          , Md          , Md          , Dd          , Dd          , Dd          , Wwt         , Wwt         , Wwr         , Wwr         , Wwt         , Wwt         , Wwt         , Wwt         , Wwt         , Wwt         , Wwf         , Wwf         , Wwt         , Wwt         , Wwt         , Wwt         , Wwt         , Wwt         , Wwt         , Wwf         , Wwt         , Wwt         , Wwt         , Ds          , Ds          , Wwt         , Wwf         , Wwf         , Wwt         , Wwt         , Ds          , Dd          , Ds          , Wwt         , Wwt         , Wwt         , Hd          , Md          , Md          , Dd          
Wo          , Wo          , Wo          , Wo          , Wwr         , Wwr         , Ww^Vm       , Wwt         , Wwt         , Ds          , Dd          , Md          , Md          , Md          , Md          , Wwt         , Wwt         , Ds          , Wwt         , Wwt         , Wwr         , Wwt         , Ds          , Wwf         , Wwf         , Wwt         , Wwt         , Wwt         , Wwt         , Wwt         , Ds          , Ds          , Wwt         , Wwt         , Wwt         , Wwt         , Wwf         , Wwf         , Wwf         , Wwf         , Wwt         , Wwt         , Wwt         , Wwt         , Wwf         , Wwf         , Wwf         , Ds          , Gg          , Ds          , Dd^Vda      , Gs^Ft       , Ds          , Hd          , Dd          , Hd          , Md          
Wo          , Wo          , Wo          , Wo          , Wo          , Wwr         , Wwt         , Wwt         , Wwt         , Ds          , Hd          , Md          , Md          , Hd          , Dd          , Dd          , Dd          , Wwt         , Wwt         , Wwr         , Wwt         , Ds          , Ds          , Wwf         , Wwf         , Wwf         , Ww^Vm       , Wwt         , Ds          , Ds          , Chw         , Chw         , 2 Kh        , Chw         , Chw         , Wwt         , Wwt         , Wwf         , Ww^Vm       , Wwt         , Wwt         , Wwt         , Wwt         , Wwt         , Wwt         , Wwf         , Wwf         , Gg          , Gs          , Ds          , Gg          , Ds          , Ds          , Dd          , Md          , Hd          , Dd          
Wo          , Wo          , Wo          , Wo          , Wo          , Wo          , Wo          , Wwt         , Wwt         , Ds          , Hd          , Md          , Hd          , Hd          , Dd          , Dd^Do       , Dd          , Wwt         , Wwt         , Wwr         , Wwt         , Wwt         , Wwt         , Wwf         , Wwt         , Wwt         , Wwt         , Wwt         , Wwt         , Ds          , Ds          , Chw         , Wwt         , Chw         , Wwt         , Wwt         , Wwt         , Wwt         , Wwt         , Wwt         , Wwt         , Wwt         , Wwt         , Wwt         , Wwt         , Wwt         , Wwt         , Ds          , Ds          , Gs          , Ds          , Gg          , Ds          , Hd          , Hd          , Hd          , Dd          
Wo          , Wo          , Wo          , Wo          , Wo          , Wo          , Wwt         , Wwt         , Gg          , Dd          , Dd          , Dd          , Dd          , Dd          , Gs          , Dd^Vdt      , Ds          , Wwt         , Wwf         , Wwr         , Wwt         , Wwt         , Wwt         , Wwt         , Wwt         , Wwt         , Wwt         , Wwt         , Wwt         , Wwt         , Ds          , Ds          , Ds          , Wwt         , Wwt         , Wwt         , Wwt         , Wwt         , Wwt         , Wwt         , Wwt         , Wwt         , Wwt         , Wwt         , Wwt         , Wwt         , Wwt         , Ds          , Ds          , Gs          , Gs          , Gs          , Ds          , Ds          , Gs^Ft       , Dd          , Gs          
Wo          , Wo          , Wo          , Wo          , Wo          , Wwr         , Wwr         , Wwt         , Wwt         , Gg          , Gg          , Gg          , Wwt         , Gs          , Gs          , Gs          , Ds          , Ds          , Wwt         , Wwt         , Wwt         , Wwt         , Wwt         , Wwt         , Wwt         , Wwt         , Wwt         , Wwt         , Wwt         , Wwt         , Wwt         , Wwt         , Wwt         , Wwt         , Wwt         , Wwt         , Wwt         , Wwt         , Wwr         , Wwt         , Wwt         , Wwt         , Wwf         , Wwf         , Wwf         , Wwt         , Wwf         , Ds          , Ds          , Ds          , Ds          , Gs          , Ds          , Ds          , Gs^Ft       , Gs^Ft       , Hh          
Wo          , Wo          , Wo          , Wo          , Wo          , Wwr         , Wwt         , Wwt         , Wwt         , Wwt         , Gg          , Gg          , Gs^Ft       , Wwt         , Wwt^Bw|     , Gg          , Gg          , Ds          , Wwt         , Wwt         , Wwt         , Wwt         , Wwt         , Wwt         , Wwr         , Wwr         , Wwr         , Wwt         , Wwt         , Wwt         , Wwt         , Ww^Vm       , Wwt         , Ww^Vm       , Wwt         , Wwt         , Wwr         , Wwr         , Wwr         , Wwr         , Wwr         , Wwf         , Wwf         , Wwf         , Ss^Vm       , Wwf         , Gg          , Gs          , Gs          , Gs          , Gs          , Gs^Ft       , Gs          , Gs          , Ss^Vhs      , Hh          , Hh          
Wo          , Wo          , Wo          , Wo          , Wo          , Wwr         , Wwt         , Wwt         , Wwt         , Wwt         , Gg          , Gg          , Gs^Ft       , Gs^Ft       , Gs          , Wwt         , Wwt         , Wwt         , Ds          , Wwt         , Wwt         , Wwt         , Wwt         , Wwt         , Wwt         , Wwr         , Wwt         , Wwt         , Wwt         , Wwt         , Wwf         , Wwf         , Wwf         , Wwt         , Wwt         , Wwt         , Wwt         , Wwt         , Wwt         , Wwf         , Wwf         , Wwf         , Wwf         , Wwf         , Ss          , Ss          , Gg^Efm      , Gg          , Gg          , Gg          , Hh^Fms      , Gs          , Hh          , Hh          , Mm          , Mm          , Mm          
Wo          , Wo          , Wo          , Wo          , Wo          , Wo          , Wo          , Wwt         , Wwt         , Wwt         , Gg          , Gs^Ft       , Gs^Ft       , Gs^Ft       , Gs          , Gs^Vl       , Wwt         , Gg          , Gs          , Ds          , Wwt         , Wwt         , Wwt         , Wwt         , Wwr         , Wwr         , Wwr         , Wwr         , Wwf         , Wwf         , Wwt         , Wwt         , Wwt         , Wwt         , Wwt         , Wwt         , Wwt         , Wwt         , Wwf         , Wwf         , Wwf         , Wwf         , Wwf         , Ss          , Ss          , Gg^Efm      , Gg          , Gg^Efm      , Hh          , Hh^Fp       , Hh          , Hh          , Wwt         , Hh          , Mm          , Mm          , Mm          
Wo          , Wo          , Wo          , Wo          , Wo          , Wo          , Wwt         , Wwt         , Wwt         , Wwt         , Gs^Ft       , Gs^Ft       , Gs^Ft       , Gs^Ft       , Gs^Ft       , Gs          , Ss          , Gs          , Gs          , Ds          , Wwt         , Ww^Vm       , Wwt         , Wwt         , Wwt         , Wwr         , Wwt         , Wwt         , Wwt         , Wwf         , Wwt         , Wwt         , Wwt         , Ds          , Ds          , Ds          , Wwt         , Wwf         , Wwf         , Wwf         , Wwf         , Wwf         , Wwt         , Wwt         , Wwt         , Gg^Efm      , Gg          , Gg^Vc       , Hh          , Hh          , Wwt         , Wwt         , Hh          , Wwt         , Mm          , Mm          , Mm          
Wo          , Wo          , Wo          , Wo          , Wwr         , Ww^Vm       , Wwt         , Wwt         , Wwt         , Wwt         , Gs^Ft       , Gg          , Gs^Ft       , Gs^Ft       , Gs^Ft       , Ss          , Gs^Ft       , Gs          , Gs^Ft       , Gs^Ft       , Ds          , Wwt         , Wwf         , Wwf         , Wwf         , Wwt         , Wwt         , Wwt         , Wwt         , Wwf         , Wwt         , Wwt         , Wwt         , Ds          , Wwt         , Wwt         , Wwt         , Wwt         , Wwt         , Wwt         , Ds          , Wwf         , Ss          , Ss          , Gg          , Wwt         , Wwt         , Wwt         , Wwt^Bw|     , Wwt         , Hh          , Hh          , Hh          , Mm          , Mm          , Mm          , Mm          
Wo          , Wo          , Wwr         , Wwr         , Wwr         , Ww^Vm       , Wwr         , Wwt         , Wwt         , Wwt         , Gs^Ft       , Gg          , Gs^Ft       , Gs^Ft       , Wwt         , Wwt         , Gs^Ft       , Gs^Ft       , Gs^Ft       , Gs^Ft       , Gs^Ft       , Gs          , Gs^Ft       , Ds          , Ds          , Wwf         , Wwf         , Wwf         , Wwt         , Wwt         , Wwt         , Wwt         , Wwt         , Wwt         , Wwt         , Wwt         , Wwt         , Wwt         , Wwt         , Ss          , Gg          , Gg          , Gg          , Gg          , Hh          , Hh^Fp       , Hh          , Gg^Efm      , Hh          , Hh          , Hh^Fp       , Hh          , Hh          , Mm          , Mm          , Mm          , Mm          
Wo          , Wo          , Wwt         , Wwt         , Wwt         , Wwr         , Wwr         , Wwt         , Wwt         , Ss          , Ss          , Gs^Ft       , Gs^Ft       , Gs^Ft       , Ss^Vhs      , Ss          , Gs^Ft       , Gs          , Ss          , Ss          , Gs^Ft       , Gs^Ft       , Gs^Ft       , Gs          , Gs          , Ds          , Ds          , Wwf         , Wwt         , Wwt         , Ds          , Wwt         , Wwt         , Wwt         , Wwt         , Wwt         , Wwt         , Wwt         , Wwt         , Ss          , Ss          , Hh          , Hh          , Hh          , Hh^Fp       , Hh^Fms      , Hh          , Hh          , Hh          , Hh^Fp       , Hh^Fms      , Hh          , Mm          , Mm          , Mm          , Hhd^Vhhr    , Mm          
Wo          , Wwt         , Mm          , Mm          , Mm          , Wwt         , Wwr         , Wwt         , Ss          , Ss          , Ss          , Gs^Ft       , Gs^Ft       , Gs^Ft       , Ss          , Ss^Bw\      , Gs^Ft       , Ss          , Ss          , Gs^Ft       , Gs^Ft       , Gs^Ft       , Gs          , Gs^Ft       , Gs          , Gs          , Gs          , Ds          , Dd          , Ds          , Dd          , Ds          , Ds          , Ds          , Ds          , Ds          , Ss          , Wwt         , Wwt         , Wwt         , Wwt         , Ss          , Hh          , Hh^Fp       , Hh          , Hh          , Wwt         , Ss^Vm       , Hh          , Hh^Fp       , Hh          , Hh          , Hh          , Mm          , Mm          , Mm          , Mm          
Wo          , Wwt         , Wwt         , Mm          , Wwt         , Wwt         , Wwr         , Wwt         , Wwt         , Ss          , Ss          , Gs^Ft       , Gs^Ft       , Gs^Ft       , Ss          , Ss^Bw|      , Gs^Ft       , Chs         , Ss          , Gs^Ft       , Gs^Ft       , Gs          , Gs          , Gs^Ft       , Ss^Bw/      , Ss^Bw/      , Gg          , Gg          , Gg^Efm      , Dd          , Dd^Do       , Dd          , Gs          , Ds          , Gs          , Gs          , Ss          , Ss          , Ss          , Ss          , Ss          , Wwt         , Wwt         , Gg          , Wwt^Bw|     , Gg^Efm      , Wwt         , Wwt         , Wwt         , Hh          , Hh          , Hh          , Mm          , Mm          , Mm          , Mm          , Mm          
Wo          , Wo          , Wwr         , Wwt         , Wwr         , Wwr         , Wwt         , Wwt         , Ss          , Wwt         , Wwt         , Wwt         , Gs^Ft       , Gs^Ft       , Ss          , Ss^Bw|      , Ss          , Ss          , Gs^Ft       , Gs^Ft       , Gs^Ft       , Gs^Ft       , Ss^Bw/      , Ss^Bw/      , Ss          , Ss          , Gs^Ft       , Gs^Ft       , Ss          , Ss          , Gs^Ft       , Gg          , Gs^Ft       , Gs          , Gs          , Gg^Efm      , Gg^Efm      , Ss          , Ss          , Ss^Vm       , Ss          , Ss          , Ss          , Wwt         , Ss^Bw\      , Wwt         , Ss          , Ss          , Hh          , Wwt         , Hh          , Mm          , Mm          , Mm          , Mm          , Mm          , Mm          
Wo          , Wo          , Wwr         , Wwr         , Wwt         , Wwr         , Wwt         , Ss          , Ss          , Ss          , Wwt         , Ss          , Gs^Ft       , Gs^Ft       , Gs^Ft       , Chr^Dr      , Chr         , Ss          , Ss          , Gs^Ft       , Gs^Ft       , Gs^Ft       , Ss^Bw|      , Ss          , Ss          , Ss          , Ss          , Ss^Vm       , Ss          , Gs^Ft       , Gs^Ft       , Gs^Ft       , Gs^Ft       , Gs^Ft       , Gs^Ft       , Gs          , Gs          , Gg^Efm      , Gg^Efm      , Ss          , Hh          , Hh          , Gg^Efm      , Wwt         , Ss          , Cud         , Cud         , Cud         , Gg          , Wwt         , Wwt         , Mm          , Mm          , Mm          , Mm          , Mm          , Mm          
Wo          , Wo          , Wo          , Wo          , Wwt         , Wwt         , Wwt         , Wwt         , Ss          , Ss          , Wwt         , Ss          , Ss          , Gs^Ft       , Ss          , Chr         , 5 Khr       , Chs         , Ss^Bw\      , Ss          , Ss          , Ss          , Ss^Bw/      , Ss          , Ss          , Ss          , Ss          , Ss          , Gs^Ft       , Gs^Ft       , Gs^Ft       , Gs^Ft       , Gs^Ft       , Gs^Ft       , Gs^Ft       , Wwt         , Wwt         , Gs          , Gg          , Hh^Fp       , Hh          , Gg          , Wwt         , Wwt         , Gg          , Cud         , Qxe         , 3 Kud       , Hh          , Mm          , Mm          , Mm          , Mm          , Mm          , Hhd^Vhhr    , Mm          , Mm          
Wo          , Wo          , Wo          , Wo          , Wwt         , Wwt         , Wwt         , Wwt         , Ss          , Ss          , Ss          , Wwt         , Ss          , Ss          , Ss          , Ss          , Chr         , Chs         , Ss          , Ss^Bw\      , Ss^Bw\      , Ss^Bw/      , Ss          , Ss^Bw\      , Wwt         , Ww^Vm       , Ss          , Ss          , Gs^Ft       , Gs^Ft       , Ss          , Gs^Ft       , Ss          , Gs^Ft       , Gs^Ft       , Wwt         , Wwt         , Wwt         , Wwt         , Gg          , Wwt         , Gg          , Wwt^Bw\     , Gg          , Hh          , Gg          , Hh          , Hh          , Hh^Fp       , Mm          , Mm          , Mm          , Mm          , Mm          , Md          , Mm          , Mm          
Wo          , Wo          , Wwt         , Wwt         , Wwt         , Wwt         , Wwt         , Ss          , Wwt         , Wwt         , Wwt         , Ss          , Ss          , Ss          , Ss          , Ss          , Ss          , Ss          , Ss          , Ss          , Ss          , Ss          , Ss          , Ss          , Ss          , Ss          , Gs^Ft       , Gs^Ft       , Gs^Ft       , Gs^Ft       , Gs^Ft       , Gs^Vc       , Ss          , Ss          , Gs^Ft       , Wwt         , Wwt         , Wwt         , Hh          , Wwt         , Wwt         , Wwt         , Hh          , Hh          , Mm          , Hh^Fp       , Mm          , Hh^Fp       , Mm          , Mm          , Mm          , Mm          , Mm          , Mm          , Mm          , Mm          , Mm          
Wo          , Wo          , Wo          , Wwt         , Wwt         , Wwt         , Wwt         , Ss          , Ss          , Wwt         , Ss          , Ss          , Ss          , Ss          , Wwt         , Wwt         , Wwt         , Ss^Vhs      , Ss          , Ss          , Ss          , Ss          , Chs         , Chs         , Ss          , Ss          , Gs^Ft       , Gs^Ft       , Gs^Ft       , Gs^Ft       , Gs^Ft       , Gs^Ft       , Gs^Ft       , Gs^Ft       , Gs^Ft       , Gs^Ft       , Gs^Ft       , Gs          , Gs          , Ww^Vm       , Mm          , Wwt         , Mm          , Mm          , Mm          , Mm          , Mm          , Mm          , Mm          , Mm          , Mm          , Mm          , Mm          , Mm          , Mm          , Mm          , Md          
Wo          , Wo          , Wwt         , Wwt         , Wwt         , Wwt         , Wwt         , Ss          , Ss          , Ss          , Ss          , Ss          , Gs^Ft       , Ss          , Ss          , Wwt         , Ss          , Ss          , Ss          , Ss          , Ss          , Gs^Ft       , Gs^Ft       , Gs^Ft       , Gs^Ft       , Gs^Ft       , Gs^Ft       , Gs^Ft       , Gs^Ft       , Gs^Ft       , Gs^Ft       , Gs^Ft       , Gs^Ft       , Gs^Ft       , Gs^Ft       , Gs^Ft       , Gs^Ft       , Gs^Ft       , Gs          , Mm          , Mm          , Mm          , Mm          , Mm          , Mm          , Mm          , Mm          , Mm          , Mm          , Mm          , Mm          , Mm          , Mm          , Mm          , Md          , Md          , Md          
Ww          , Wo          , Wo          , Wwt         , Wwt         , Wwt         , Wwt         , Gg          , Gg          , Ss          , Gg          , Gs^Ft       , Gs^Ft       , Gs^Ft       , Gg          , Gs^Ft       , Gg          , Gs^Ft       , Gg          , Gs^Ft       , Gg          , Gs^Ft       , Gg          , Gs^Ft       , Gs^Ft       , Gs^Ft       , Gs^Ft       , Gs^Ft       , Gs^Ft       , Gs^Ft       , Gs^Ft       , Gs^Ft       , Gs^Ft       , Gs^Ft       , Gg          , Gs^Ft       , Gg          , Gs^Fp       , Gs^Fp       , Gs^Fp       , Hh          , Mm          , Mm          , Mm          , Mm          , Mm          , Md          , Md          , Md          , Mm          , Mm          , Mm          , Mm          , Md          , Md          , Md          , Md          
